lo-fi indie	lo-fi indie	1
bedroom	bedroom	1
dream pop	dream pop	1
fresh discoveries	fresh discoveries	1
sad indie	sad indie	1
folk	folk	1
singer-songwriter	singer-songwriter	1
indie-cisive	indie-cisive	1
lazy indie	lazy indie	1
relax & focus	relax & focus	1
rap	rap	1
r&b -rrb-	r&b -rrb-	1
underground indie : lo-fi , noise pop , etc. .	underground indie : lo-fi , noise pop , etc. .	1
indie beach day	indie beach day	1
movie soundtracks with piano	movie soundtracks with piano	1
alt-country - new americana - folk	alt-country - new americana - folk	1
indie rock	indie rock	1
surf rock	surf rock	1
jangle pop	jangle pop	1
evening relax	evening relax	1
weekend chill	weekend chill	1
movie soundtracks - violin	movie soundtracks - violin	1
beach bar boutique : vol13	beach bar boutique : vol13	1
electronic	electronic	1
ambient	ambient	1
future garage	future garage	1
indie folk favorites	indie folk favorites	1
undiscovered indie & folk gems	undiscovered indie & folk gems	1
pop & rock live in concert	pop & rock live in concert	1
legendary live jazz	legendary live jazz	1
the leftovers -lrb- revisited -rrb-	the leftovers -lrb- revisited -rrb-	1
pop folk for purists	pop folk for purists	1
multilingual jazz	multilingual jazz	1
chillin ' & grillin '	chillin ' & grillin '	1
radiohead	radiohead	1
chill afternoon	chill afternoon	1
fantastic eighties	fantastic eighties	1
the finest jazz of all times	the finest jazz of all times	1
sensational sixties	sensational sixties	1
bass culture : when reggae was king	bass culture : when reggae was king	1
female folk	female folk	1
wonderful seventies	wonderful seventies	1
summer oldies & hits	summer oldies & hits	1
radiohead	radiohead	1
bauhaus	bauhaus	1
gene olympian	gene olympian	1
this is america	this is america	1
movie soundtracks with choirs & vocals	movie soundtracks with choirs & vocals	1
g-house	g-house	1
campfire hits	campfire hits	1
soul classics & rap samples	soul classics & rap samples	1
the cure - singles	the cure - singles	1
glam rock hits	glam rock hits	1
lofi hiphop	lofi hiphop	1
toe tapping happy sing along songs	toe tapping happy sing along songs	1
tomorrow 's hits	tomorrow 's hits	1
rock up north	rock up north	1
california love summer bbq rap	california love summer bbq rap	1
my chemical romance	my chemical romance	1
american tunes	american tunes	1
fashion forward electronic music	fashion forward electronic music	1
composers	composers	1
coldplay	coldplay	1
future bass	future bass	1
house	house	1
music from the john lewis ad	music from the john lewis ad	1
the clash	the clash	1
deep , dark and often mysterious .	deep , dark and often mysterious .	1
r.e.m	r.e.m	1
billy joel	billy joel	1
beatles and others	beatles and others	1
billy joel	billy joel	1
bauhaus	bauhaus	1
roy orbison	roy orbison	1
we love rock ballads	we love rock ballads	1
james	james	1
catherine wheel	catherine wheel	1
best break dance songs	best break dance songs	1
feeder	feeder	1
justice league : music of the gods	justice league : music of the gods	1
placebo	placebo	1
madness	madness	1
billy joel	billy joel	1
have a great day !	have a great day !	1
new music friday	new music friday	1
walk in like you own the place	walk in like you own the place	1
i love my ’90 s r&b	i love my ’90 s r&b	1
’90 s rock renaissance	’90 s rock renaissance	1
gold school	gold school	1
’80 s rock hits !	’80 s rock hits !	1
original outlaws	original outlaws	1
throwback thursday	throwback thursday	1
happy days	happy days	1
funky jazz , blues , & soul	funky jazz , blues , & soul	1
daft punk 's favorites -lrb- guy-manuel de homem-christo -rrb-	daft punk 's favorites -lrb- guy-manuel de homem-christo -rrb-	1
snoop dogg 's merry jane playlist	snoop dogg 's merry jane playlist	1
this is : sir george martin	this is : sir george martin	1
this is : max martin	this is : max martin	1
this is : disney	this is : disney	1
songs to test headphones with	songs to test headphones with	1
instrumental hip-hop	instrumental hip-hop	1
family road trip	family road trip	1
indie workout	indie workout	1
bass drops	bass drops	1
future beats	future beats	1
grimy rap	grimy rap	1
today 's top hits	today 's top hits	1
dance mega mix	dance mega mix	1
hip hop monsters	hip hop monsters	1
ultimate country	ultimate country	1
mood booster	mood booster	1
teen party	teen party	1
cardio	cardio	1
your favorite coffeehouse	your favorite coffeehouse	1
weekend hangouts	weekend hangouts	1
¡ baila reggaeton !	¡ baila reggaeton !	1
fresh dance tracks	fresh dance tracks	1
girls ' night	girls ' night	1
songs to sing in the shower	songs to sing in the shower	1
acoustic morning	acoustic morning	1
deep focus	deep focus	1
power workout	power workout	1
acoustic lounge	acoustic lounge	1
top of the charts playlist	top of the charts playlist	1
greatest songs ever	greatest songs ever	1
upbeat + summer sun	upbeat + summer sun	1
