relativistic baseball	relativistic baseball	1
sat guessing	sat guessing	1
yoda	yoda	1
a mole of moles	a mole of moles	1
robot apocalypse	robot apocalypse	1
glass half empty	glass half empty	1
everybody out	everybody out	1
everybody jump	everybody jump	1
soul mates	soul mates	1
cassini	cassini	1
droppings	droppings	1
raindrop	raindrop	1
laser pointer	laser pointer	1
short answer section	short answer section	1
mariana trench explosion	mariana trench explosion	1
today 's topic : lightning	today 's topic : lightning	1
green cows	green cows	1
bb gun	bb gun	1
tie vote	tie vote	1
diamond	diamond	1
machine gun jetpack	machine gun jetpack	1
cost of pennies	cost of pennies	1
short answer section ii	short answer section ii	1
model rockets	model rockets	1
leap seconds	leap seconds	1
death rates	death rates	1
steak drop	steak drop	1
spent fuel pool	spent fuel pool	1
interplanetary cessna	interplanetary cessna	1
fedex bandwidth	fedex bandwidth	1
hubble	hubble	1
ships	ships	1
twitter	twitter	1
hair dryer	hair dryer	1
cornstarch	cornstarch	1
supersonic stereo	supersonic stereo	1
voyager	voyager	1
hockey puck	hockey puck	1
pressure cooker	pressure cooker	1
go west	go west	1
longest sunset	longest sunset	1
train loop	train loop	1
high throw	high throw	1
iss music video	iss music video	1
bowling ball	bowling ball	1
alien astronomers	alien astronomers	1
sunless earth	sunless earth	1
extreme boating	extreme boating	1
free fall	free fall	1
bouncy balls	bouncy balls	1
drain the oceans	drain the oceans	1
drain the oceans : part ii	drain the oceans : part ii	1
random sneeze call	random sneeze call	1
restraining an airplane	restraining an airplane	1
dropping a mountain	dropping a mountain	1
orbital speed	orbital speed	1
updating a printed wikipedia	updating a printed wikipedia	1
signs of life	signs of life	1
speed bump	speed bump	1
falling with helium	falling with helium	1
google 's datacenters on punch cards	google 's datacenters on punch cards	1
rising steadily	rising steadily	1
twitter timeline height	twitter timeline height	1
expanding earth	expanding earth	1
little planet	little planet	1
facebook of the dead	facebook of the dead	1
the constant groundskeeper	the constant groundskeeper	1
stirring tea	stirring tea	1
loneliest human	loneliest human	1
lethal neutrinos	lethal neutrinos	1
soda planet	soda planet	1
phone keypad	phone keypad	1
reading every book	reading every book	1
growth rate	growth rate	1
t-rex calories	t-rex calories	1
lake tea	lake tea	1
pile of viruses	pile of viruses	1
catch !	catch !	1
hitting a comet	hitting a comet	1
star sand	star sand	1
paint the earth	paint the earth	1
rocket golf	rocket golf	1
far-traveling objects	far-traveling objects	1
enforced by radar	enforced by radar	1
soda sequestration	soda sequestration	1
tungsten countertop	tungsten countertop	1
great tree , great axe	great tree , great axe	1
faucet power	faucet power	1
one-second day	one-second day	1
windshield raindrops	windshield raindrops	1
billion-story building	billion-story building	1
pyramid energy	pyramid energy	1
burning pollen	burning pollen	1
blood alcohol	blood alcohol	1
starlings	starlings	1
wwii films	wwii films	1
plastic dinosaurs	plastic dinosaurs	1
keyboard power	keyboard power	1
vanishing water	vanishing water	1
global snow	global snow	1
cannibalism	cannibalism	1
ink molecules	ink molecules	1
letter to mom	letter to mom	1
expensive shoebox	expensive shoebox	1
into the blue	into the blue	1
all the money	all the money	1
balloon car	balloon car	1
visit every state	visit every state	1
antimatter	antimatter	1
into the sun	into the sun	1
no-rules nascar	no-rules nascar	1
distant death	distant death	1
physical salary	physical salary	1
laser umbrella	laser umbrella	1
alternate universe what ifs	alternate universe what ifs	1
frozen rivers	frozen rivers	1
lava lamp	lava lamp	1
fairy demographics	fairy demographics	1
lunar swimming	lunar swimming	1
bowling ball	bowling ball	1
stairs	stairs	1
tug of war	tug of war	1
zippo phone	zippo phone	1
black hole moon	black hole moon	1
snow removal	snow removal	1
microwaves	microwaves	1
hotter than average	hotter than average	1
flagpole	flagpole	1
space burial	space burial	1
digging downward	digging downward	1
spiders vs. the sun	spiders vs. the sun	1
new horizons	new horizons	1
jupiter descending	jupiter descending	1
proton earth , electron moon	proton earth , electron moon	1
sunbeam	sunbeam	1
space jetta	space jetta	1
europa water siphon	europa water siphon	1
saliva pool	saliva pool	1
fire from moonlight	fire from moonlight	1
stop jupiter	stop jupiter	1
niagara straw	niagara straw	1
eat the sun	eat the sun	1
pizza bird	pizza bird	1
tatooine rainbow	tatooine rainbow	1
sun bug	sun bug	1
flood death valley	flood death valley	1
hide the atmosphere	hide the atmosphere	1
coast-to-coast coasting	coast-to-coast coasting	1
toaster vs. freezer	toaster vs. freezer	1
electrofishing for whales	electrofishing for whales	1
earth-moon fire pole	earth-moon fire pole	1
