pop	pop	1
dance pop	dance pop	1
post-teen pop	post-teen pop	1
electropop	electropop	1
pop rap	pop rap	1
tropical house	tropical house	1
r&b	r & b	1
urban contemporary	urban contemporary	1
pop rock	pop rock	1
indie poptimism	indie poptimism	1
viral pop	viral pop	1
edm	edm	1
neo mellow	neo mellow	1
hip pop	hip pop	1
uk pop	uk pop	1
indie pop	indie pop	1
indietronica	indietronica	1
indie cafe pop	indie cafe pop	1
chinese idol pop	chinese idol pop	1
neo soul	neo soul	1
alternative r&b	alternative r & b	1
deep pop r&b	deep pop r & b	1
japanese r&b	japanese r & b	1
deep dance pop	deep dance pop	1
junior eurovision	junior eurovision	1
modern rock	modern rock	1
social media pop	social media pop	1
electro house	electro house	1
redneck	redneck	1
rap	rap	1
latin viral pop	latin viral pop	1
finnish dance pop	finnish dance pop	1
eurovision	eurovision	1
chinese electropop	chinese electropop	1
australian hip hop	australian hip hop	1
danish pop	danish pop	1
k-pop	k-pop	1
belarusian pop	belarusian pop	1
ukrainian pop	ukrainian pop	1
ukrainian rock	ukrainian rock	1
mexican pop	mexican pop	1
emo rap italiano	emo rap italiano	1
swiss pop	swiss pop	1
pop argentino	pop argentino	1
bulgarian rock	bulgarian rock	1
cape town indie	cape town indie	1
swedish idol pop	swedish idol pop	1
teen pop	teen pop	1
mongolian pop	mongolian pop	1
swedish pop	swedish pop	1
boy band	boy band	1
italian arena pop	italian arena pop	1
australian electropop	australian electropop	1
pop electronico	pop electronico	1
australian r&b	australian r & b	1
kazakh pop	kazakh pop	1
indie salvadoreno	indie salvadoreno	1
german pop	german pop	1
thai indie	thai indie	1
thai indie pop	thai indie pop	1
russian dance pop	russian dance pop	1
deep turkish pop	deep turkish pop	1
lithuanian pop	lithuanian pop	1
south african pop	south african pop	1
swedish electropop	swedish electropop	1
bulgarian pop	bulgarian pop	1
europop	europop	1
antiviral pop	antiviral pop	1
british soul	british soul	1
russian pop	russian pop	1
bosnian indie	bosnian indie	1
ukrainian indie	ukrainian indie	1
christian afrobeat	christian afrobeat	1
scream rap	scream rap	1
j-rap	j-rap	1
spanish pop rock	spanish pop rock	1
venezuelan indie	venezuelan indie	1
australian pop	australian pop	1
montenegrin pop	montenegrin pop	1
latin alternative	latin alternative	1
korean city pop	korean city pop	1
talent show	talent show	1
escape room	escape room	1
uae indie	uae indie	1
colombian rock	colombian rock	1
latin arena pop	latin arena pop	1
czech hip hop	czech hip hop	1
belgian pop	belgian pop	1
swiss indie	swiss indie	1
new jack smooth	new jack smooth	1
bolivian rock	bolivian rock	1
chinese manyao	chinese manyao	1
german indie pop	german indie pop	1
mexican indie	mexican indie	1
canadian electropop	canadian electropop	1
polish pop	polish pop	1
hungarian pop	hungarian pop	1
polish reggae	polish reggae	1
thai pop	thai pop	1
la pop	la pop	1
danish pop rock	danish pop rock	1
malaysian hip hop	malaysian hip hop	1
tamil hip hop	tamil hip hop	1
trap metal italiana	trap metal italiana	1
classic portuguese pop	classic portuguese pop	1
swedish soul	swedish soul	1
k-pop boy group	k-pop boy group	1
brasilia indie	brasilia indie	1
argentine telepop	argentine telepop	1
south african alternative	south african alternative	1
musica rondoniense	musica rondoniense	1
melodipop	melodipop	1
tunisian pop	tunisian pop	1
country rap	country rap	1
tatar pop	tatar pop	1
moldovan pop	moldovan pop	1
thai rock	thai rock	1
j-dance	j-dance	1
okinawan pop	okinawan pop	1
burmese pop	burmese pop	1
scandipop	scandipop	1
maltese pop	maltese pop	1
japanese trap	japanese trap	1
reggae catala	reggae catala	1
milan indie	milan indie	1
spanish pop	spanish pop	1
francoton	francoton	1
antideutsche	antideutsche	1
finnish pop	finnish pop	1
pop nacional	pop nacional	1
zim hip hop	zim hip hop	1
shibuya-kei	shibuya-kei	1
czsk hip hop	czsk hip hop	1
macedonian pop	macedonian pop	1
russian indie	russian indie	1
hmong pop	hmong pop	1
russian dance	russian dance	1
cedm	cedm	1
myanmar indie	myanmar indie	1
mundart	mundart	1
new wave pop	new wave pop	1
mestissatge	mestissatge	1
indie electropop	indie electropop	1
indonesian reggae	indonesian reggae	1
latin pop	latin pop	1
indie pop rap	indie pop rap	1
estonian hip hop	estonian hip hop	1
thai indie rock	thai indie rock	1
christian hip hop	christian hip hop	1
aussietronica	aussietronica	1
nightcore	nightcore	1
kavkaz	kavkaz	1
estonian pop	estonian pop	1
armenian pop	armenian pop	1
sertanejo gospel	sertanejo gospel	1
leon gto indie	leon gto indie	1
variete francaise	variete francaise	1
minecraft	minecraft	1
russian hip hop	russian hip hop	1
canadian latin	canadian latin	1
mexican rock	mexican rock	1
classic bulgarian pop	classic bulgarian pop	1
portuguese pop	portuguese pop	1
jordanian pop	jordanian pop	1
rap napoletano	rap napoletano	1
austrian pop	austrian pop	1
rock mineiro	rock mineiro	1
musica londrinense	musica londrinense	1
belarusian indie	belarusian indie	1
israeli hip hop	israeli hip hop	1
japanese soul	japanese soul	1
ska argentino	ska argentino	1
brazilian ska	brazilian ska	1
musica capixaba	musica capixaba	1
glitchcore	glitchcore	1
peruvian indie	peruvian indie	1
russelater	russelater	1
rock en espanol	rock en espanol	1
indie boliviano	indie boliviano	1
german indie	german indie	1
new rave	new rave	1
turbo folk	turbo folk	1
reggae rock	reggae rock	1
schlager	schlager	1
salzburg indie	salzburg indie	1
graz indie	graz indie	1
turkish trap pop	turkish trap pop	1
kosovan pop	kosovan pop	1
barbadian pop	barbadian pop	1
scandinavian r&b	scandinavian r & b	1
latvian rock	latvian rock	1
rock kapak	rock kapak	1
persian pop	persian pop	1
indonesian idol pop	indonesian idol pop	1
thai folk rock	thai folk rock	1
puerto rican pop	puerto rican pop	1
alternative dance	alternative dance	1
italian hip hop	italian hip hop	1
uzbek pop	uzbek pop	1
new jack swing	new jack swing	1
rap galego	rap galego	1
new romantic	new romantic	1
latin rock	latin rock	1
indonesian pop	indonesian pop	1
deep pop edm	deep pop edm	1
pop paraguayo	pop paraguayo	1
russian trap	russian trap	1
guadalajara indie	guadalajara indie	1
guatemalan pop	guatemalan pop	1
spanish rock	spanish rock	1
grime	grime	1
techno kayo	techno kayo	1
scottish hip hop	scottish hip hop	1
shimmer pop	shimmer pop	1
underground hip hop	underground hip hop	1
japanese electropop	japanese electropop	1
albanian pop	albanian pop	1
paraguayan indie	paraguayan indie	1
chalga	chalga	1
pop chileno	pop chileno	1
horrorcore	horrorcore	1
pony	pony	1
trap italiana	trap italiana	1
psychokore	psychokore	1
monterrey indie	monterrey indie	1
swedish synthpop	swedish synthpop	1
hong kong hip hop	hong kong hip hop	1
south african punk	south african punk	1
australian dance	australian dance	1
swedish eurodance	swedish eurodance	1
norwegian pop rap	norwegian pop rap	1
deep latin alternative	deep latin alternative	1
mashup	mashup	1
assyrian pop	assyrian pop	1
persian hip hop	persian hip hop	1
rap cristiano	rap cristiano	1
neomelodici	neomelodici	1
slovak rock	slovak rock	1
caracas indie	caracas indie	1
venezuelan rock	venezuelan rock	1
german pop rock	german pop rock	1
transpop	transpop	1
synthpop	synthpop	1
musica amapaense	musica amapaense	1
zambian pop	zambian pop	1
australian alternative pop	australian alternative pop	1
israeli mediterranean	israeli mediterranean	1
korean r&b	korean r & b	1
thai idol	thai idol	1
neue deutsche welle	neue deutsche welle	1
cologne indie	cologne indie	1
munich indie	munich indie	1
carnaval	carnaval	1
uk alternative pop	uk alternative pop	1
girl group	girl group	1
deep german indie	deep german indie	1
rock nacional brasileiro	rock nacional brasileiro	1
belarusian rock	belarusian rock	1
tajik pop	tajik pop	1
italian alternative	italian alternative	1
abstract hip hop	abstract hip hop	1
african rock	african rock	1
yugoslav new wave	yugoslav new wave	1
indie catracho	indie catracho	1
fremantle indie	fremantle indie	1
deep smooth r&b	deep smooth r & b	1
austrian hip hop	austrian hip hop	1
classic french pop	classic french pop	1
kolsche karneval	kolsche karneval	1
ohio hip hop	ohio hip hop	1
vapor pop	vapor pop	1
rock nica	rock nica	1
reggaeton cristiano	reggaeton cristiano	1
classic russian pop	classic russian pop	1
turkish pop	turkish pop	1
dark trap	dark trap	1
egyptian pop	egyptian pop	1
indian rock	indian rock	1
russian rock	russian rock	1
hungarian rock	hungarian rock	1
dangdut	dangdut	1
coventry indie	coventry indie	1
polish synthpop	polish synthpop	1
hyperpop	hyperpop	1
musica eletronica gospel	musica eletronica gospel	1
maine hip hop	maine hip hop	1
croatian rock	croatian rock	1
christlicher rap	christlicher rap	1
hamburger schule	hamburger schule	1
magyar alternative	magyar alternative	1
dutch idol pop	dutch idol pop	1
polynesian pop	polynesian pop	1
panamanian indie	panamanian indie	1
kiwi rock	kiwi rock	1
chicago rap	chicago rap	1
latvian pop	latvian pop	1
deep r&b	deep r & b	1
shaabi	shaabi	1
classic belgian pop	classic belgian pop	1
norwegian hip hop	norwegian hip hop	1
indonesian indie	indonesian indie	1
guitar case	guitar case	1
puglia indie	puglia indie	1
euskal indie	euskal indie	1
puerto rican rock	puerto rican rock	1
swiss hip hop	swiss hip hop	1
middle east hip hop	middle east hip hop	1
ghanaian gospel	ghanaian gospel	1
deep flow	deep flow	1
sinhala rap	sinhala rap	1
slovenian pop	slovenian pop	1
japanese new wave	japanese new wave	1
country road	country road	1
malaysian tamil pop	malaysian tamil pop	1
j-indie	j-indie	1
kyrgyz pop	kyrgyz pop	1
rock piauiense	rock piauiense	1
australian reggae fusion	australian reggae fusion	1
korean trap	korean trap	1
j-reggae	j-reggae	1
dutch pop	dutch pop	1
arab pop	arab pop	1
karneval	karneval	1
russian reggae	russian reggae	1
nyc pop	nyc pop	1
r&b italiano	r & b italiano	1
welsh hip hop	welsh hip hop	1
alberta country	alberta country	1
french indie pop	french indie pop	1
taiwan pop	taiwan pop	1
levenslied	levenslied	1
chihuahua indie	chihuahua indie	1
ecuadorian indie	ecuadorian indie	1
australian talent show	australian talent show	1
peruvian rock	peruvian rock	1
adoracion	adoracion	1
slovak hip hop	slovak hip hop	1
military rap	military rap	1
christian trap	christian trap	1
zouk riddim	zouk riddim	1
j-pop boy group	j-pop boy group	1
thai hip hop	thai hip hop	1
electronica cristiana	electronica cristiana	1
drill	drill	1
dance-punk	dance-punk	1
latin funk	latin funk	1
telugu worship	telugu worship	1
russian synthpop	russian synthpop	1
volkspop	volkspop	1
j-pop	j-pop	1
electronica argentina	electronica argentina	1
kenyan pop	kenyan pop	1
bern indie	bern indie	1
lgbtq+ hip hop	lgbtq + hip hop	1
kwaito	kwaito	1
volkstumliche musik	volkstumliche musik	1
rock uruguayo	rock uruguayo	1
latin	latin	1
russian gangster rap	russian gangster rap	1
rock alagoano	rock alagoano	1
seattle hip hop	seattle hip hop	1
chinese viral pop	chinese viral pop	1
turkish hip hop	turkish hip hop	1
gospel reggae	gospel reggae	1
chip hop	chip hop	1
indonesian hip hop	indonesian hip hop	1
bass trap	bass trap	1
nordic house	nordic house	1
rock gaucho	rock gaucho	1
contemporary country	contemporary country	1
chechen pop	chechen pop	1
moroccan pop	moroccan pop	1
bangladeshi indie	bangladeshi indie	1
german rock	german rock	1
afrikaans	afrikaans	1
k-rap	k-rap	1
alpine yodeling	alpine yodeling	1
deep german hip hop	deep german hip hop	1
ska catala	ska catala	1
rebel blues	rebel blues	1
metropopolis	metropopolis	1
vienna indie	vienna indie	1
canadian contemporary r&b	canadian contemporary r & b	1
funk mexicano	funk mexicano	1
greenlandic pop	greenlandic pop	1
denver rap	denver rap	1
deep new wave	deep new wave	1
carimbo	carimbo	1
mizrahi	mizrahi	1
hamburg indie	hamburg indie	1
soul flow	soul flow	1
rock chapin	rock chapin	1
country pop	country pop	1
slow game	slow game	1
chilean indie	chilean indie	1
future bass	future bass	1
australian underground hip hop	australian underground hip hop	1
spanish new wave	spanish new wave	1
schweizer rap	schweizer rap	1
nerdcore	nerdcore	1
deep talent show	deep talent show	1
native american hip hop	native american hip hop	1
doujin	doujin	1
italian pop rock	italian pop rock	1
neo-synthpop	neo-synthpop	1
hopebeat	hopebeat	1
covertrance	covertrance	1
japanese city pop	japanese city pop	1
latin christian	latin christian	1
french indietronica	french indietronica	1
italian new wave	italian new wave	1
croatian indie	croatian indie	1
retro soul	retro soul	1
greek underground rap	greek underground rap	1
nova musica maranhense	nova musica maranhense	1
zimdancehall	zimdancehall	1
nz pop	nz pop	1
romanian pop	romanian pop	1
soviet synthpop	soviet synthpop	1
polish hip hop	polish hip hop	1
gulf hip hop	gulf hip hop	1
strut	strut	1
colombian indie	colombian indie	1
solipsynthm	solipsynthm	1
pop virale italiano	pop virale italiano	1
luk thung	luk thung	1
chicago drill	chicago drill	1
turkish alternative	turkish alternative	1
elektropunk	elektropunk	1
malaysian pop	malaysian pop	1
gypsy fusion	gypsy fusion	1
chinese hip hop	chinese hip hop	1
azeri pop	azeri pop	1
russian punk	russian punk	1
indie nica	indie nica	1
arabic hip hop	arabic hip hop	1
romanian hip hop	romanian hip hop	1
zurich indie	zurich indie	1
spanish synthpop	spanish synthpop	1
deep indie rock	deep indie rock	1
pittsburgh rap	pittsburgh rap	1
puerto rican indie	puerto rican indie	1
yugoslav rock	yugoslav rock	1
idol	idol	1
traprun	traprun	1
neo soul-jazz	neo soul-jazz	1
modern country rock	modern country rock	1
finnish soul	finnish soul	1
funk rock	funk rock	1
swiss rock	swiss rock	1
christian pop	christian pop	1
circassian folk	circassian folk	1
cdmx indie	cdmx indie	1
boston hip hop	boston hip hop	1
polish alternative	polish alternative	1
malagasy pop	malagasy pop	1
kaneka	kaneka	1
vapor soul	vapor soul	1
gypsy punk	gypsy punk	1
west australian hip hop	west australian hip hop	1
new wave	new wave	1
jewish hip hop	jewish hip hop	1
turkish trap	turkish trap	1
german hip hop	german hip hop	1
panamanian rock	panamanian rock	1
vegas indie	vegas indie	1
musica roraimense	musica roraimense	1
carnaval limburg	carnaval limburg	1
musica popular paraense	musica popular paraense	1
japanese jazztronica	japanese jazztronica	1
deep underground hip hop	deep underground hip hop	1
lustrum	lustrum	1
danish hip hop	danish hip hop	1
polish alternative rap	polish alternative rap	1
asian american hip hop	asian american hip hop	1
belgian rock	belgian rock	1
gospel rap	gospel rap	1
baile pop	baile pop	1
electrofox	electrofox	1
israeli trap	israeli trap	1
dominican indie	dominican indie	1
bmore	bmore	1
australian indie	australian indie	1
paraguayan rock	paraguayan rock	1
belgian new wave	belgian new wave	1
dance rock	dance rock	1
gauze pop	gauze pop	1
french reggae	french reggae	1
swiss country	swiss country	1
pop costarricense	pop costarricense	1
pinoy reggae	pinoy reggae	1
russian chanson	russian chanson	1
german ska	german ska	1
ukrainian folk	ukrainian folk	1
brazilian rock	brazilian rock	1
east coast reggae	east coast reggae	1
rock cristiano	rock cristiano	1
danish electropop	danish electropop	1
sega mauricien	sega mauricien	1
polish trap	polish trap	1
amharic pop	amharic pop	1
taiwan hip hop	taiwan hip hop	1
vietnamese hip hop	vietnamese hip hop	1
rwandan pop	rwandan pop	1
chennai indie	chennai indie	1
zambian hip hop	zambian hip hop	1
electropowerpop	electropowerpop	1
pop edm	pop edm	1
indiana hip hop	indiana hip hop	1
leipzig indie	leipzig indie	1
pinoy indie	pinoy indie	1
industrial hip hop	industrial hip hop	1
afro r&b	afro r & b	1
danspunk	danspunk	1
nepali indie	nepali indie	1
lezginka	lezginka	1
candy pop	candy pop	1
canadian contemporary country	canadian contemporary country	1
batak	batak	1
portland hip hop	portland hip hop	1
finnish hip hop	finnish hip hop	1
smooth soul	smooth soul	1
hamilton on indie	hamilton on indie	1
mangue bit	mangue bit	1
suomi rock	suomi rock	1
zhongguo feng	zhongguo feng	1
irish underground rap	irish underground rap	1
indonesian indie pop	indonesian indie pop	1
detroit indie	detroit indie	1
electronic rock	electronic rock	1
malaysian indie	malaysian indie	1
deep acoustic pop	deep acoustic pop	1
rock paraibana	rock paraibana	1
lithuanian rock	lithuanian rock	1
nz hip hop	nz hip hop	1
glee club	glee club	1
south african hip hop	south african hip hop	1
czsk reggae	czsk reggae	1
beatboxing	beatboxing	1
r&b brasileiro	r & b brasileiro	1
dutch r&b	dutch r & b	1
swedish hip hop	swedish hip hop	1
argentine rock	argentine rock	1
psychedelic hip hop	psychedelic hip hop	1
kolkata indie	kolkata indie	1
vocaloid	vocaloid	1
colombian pop	colombian pop	1
australian trap	australian trap	1
gospel r&b	gospel r & b	1
rap metalcore	rap metalcore	1
pernambuco alternative	pernambuco alternative	1
emo rap	emo rap	1
desi hip hop	desi hip hop	1
chilean rock	chilean rock	1
milwaukee hip hop	milwaukee hip hop	1
lo star	lo star	1
polish indie	polish indie	1
italian underground hip hop	italian underground hip hop	1
rap antillais	rap antillais	1
ska espanol	ska espanol	1
trio batak	trio batak	1
atl hip hop	atl hip hop	1
rap alagoano	rap alagoano	1
indie liguria	indie liguria	1
bc underground hip hop	bc underground hip hop	1
nashville hip hop	nashville hip hop	1
finlandssvenska musik	finlandssvenska musik	1
south carolina hip hop	south carolina hip hop	1
rif	rif	1
kent indie	kent indie	1
alternative pop rock	alternative pop rock	1
namibian pop	namibian pop	1
irish hip hop	irish hip hop	1
canadian hip hop	canadian hip hop	1
gaming edm	gaming edm	1
greek hip hop	greek hip hop	1
kizomba	kizomba	1
veracruz indie	veracruz indie	1
birmingham grime	birmingham grime	1
botswana pop	botswana pop	1
norwegian country	norwegian country	1
dusseldorf indie	dusseldorf indie	1
punjabi hip hop	punjabi hip hop	1
vapor twitch	vapor twitch	1
bergen indie	bergen indie	1
togolese pop	togolese pop	1
galician indie	galician indie	1
classic j-rock	classic j-rock	1
kenyan alternative	kenyan alternative	1
turin indie	turin indie	1
baithak gana	baithak gana	1
swahili gospel	swahili gospel	1
indie cantabria	indie cantabria	1
romanian trap	romanian trap	1
post-punk argentina	post-punk argentina	1
southern hip hop	southern hip hop	1
musica mallorquina	musica mallorquina	1
uppsala indie	uppsala indie	1
uk christian rap	uk christian rap	1
pop quebecois	pop quebecois	1
kawaii future bass	kawaii future bass	1
chinese new year	chinese new year	1
miami hip hop	miami hip hop	1
rosario indie	rosario indie	1
merida indie	merida indie	1
tallava	tallava	1
swedish trap pop	swedish trap pop	1
musica popular amazonense	musica popular amazonense	1
sudanese pop	sudanese pop	1
guatemalan indie	guatemalan indie	1
uruguayan indie	uruguayan indie	1
slovak pop	slovak pop	1
murcia indie	murcia indie	1
indian indie	indian indie	1
geek rock	geek rock	1
swedish gangsta rap	swedish gangsta rap	1
afrofuturismo brasileiro	afrofuturismo brasileiro	1
la indie	la indie	1
german country	german country	1
rap uruguayo	rap uruguayo	1
spiritual hip hop	spiritual hip hop	1
indie veneto	indie veneto	1
rhode island rap	rhode island rap	1
rap catalan	rap catalan	1
hip hop quebecois	hip hop quebecois	1
korean indie rock	korean indie rock	1
brazilian indie	brazilian indie	1
synth funk	synth funk	1
croatian pop	croatian pop	1
dangdut koplo	dangdut koplo	1
finnish worship	finnish worship	1
swedish tropical house	swedish tropical house	1
freestyle	freestyle	1
trap cristiano	trap cristiano	1
swedish country	swedish country	1
trap	trap	1
latvian indie	latvian indie	1
indie paraense	indie paraense	1
croatian hip hop	croatian hip hop	1
german alternative rap	german alternative rap	1
k-rock	k-rock	1
zim gospel	zim gospel	1
dansband	dansband	1
egyptian alternative	egyptian alternative	1
portuguese rock	portuguese rock	1
uk hip hop	uk hip hop	1
hawaiian indie	hawaiian indie	1
inuit pop	inuit pop	1
polynesian hip hop	polynesian hip hop	1
khmer	khmer	1
german cloud rap	german cloud rap	1
myanmar hip hop	myanmar hip hop	1
vispop	vispop	1
hamburg hip hop	hamburg hip hop	1
latvian hip hop	latvian hip hop	1
pop minang	pop minang	1
argentine indie	argentine indie	1
pakistani hip hop	pakistani hip hop	1
k-pop girl group	k-pop girl group	1
musica catarinense	musica catarinense	1
korean pop	korean pop	1
classic danish pop	classic danish pop	1
gamecore	gamecore	1
winnipeg hip hop	winnipeg hip hop	1
sertanejo pop	sertanejo pop	1
disco	disco	1
k-indie	k-indie	1
danseband	danseband	1
indie cordoba	indie cordoba	1
musica aragonesa	musica aragonesa	1
talentos brasileiros	talentos brasileiros	1
rap toscana	rap toscana	1
indie curitibano	indie curitibano	1
pinoy rock	pinoy rock	1
spanish electropop	spanish electropop	1
argentine alternative rock	argentine alternative rock	1
musique guadeloupe	musique guadeloupe	1
albuquerque indie	albuquerque indie	1
kansas hip hop	kansas hip hop	1
lithuanian hip hop	lithuanian hip hop	1
indie extremena	indie extremena	1
icelandic hip hop	icelandic hip hop	1
political hip hop	political hip hop	1
north carolina hip hop	north carolina hip hop	1
electronic trap	electronic trap	1
spanish folk rock	spanish folk rock	1
trap cristao	trap cristao	1
uk contemporary r&b	uk contemporary r & b	1
polish rock	polish rock	1
wrestling	wrestling	1
australian rock	australian rock	1
bitpop	bitpop	1
pop venezolano	pop venezolano	1
hong kong indie	hong kong indie	1
shiver pop	shiver pop	1
japanese indie pop	japanese indie pop	1
classic thai pop	classic thai pop	1
ostrock	ostrock	1
australian ska	australian ska	1
iraqi pop	iraqi pop	1
australian country	australian country	1
sholawat	sholawat	1
rome indie	rome indie	1
lebanese pop	lebanese pop	1
rap ivoire	rap ivoire	1
trap espanol	trap espanol	1
texas latin rap	texas latin rap	1
future funk	future funk	1
volksmusik	volksmusik	1
german underground rap	german underground rap	1
bulgarian indie	bulgarian indie	1
kurdish hip hop	kurdish hip hop	1
canadian pop	canadian pop	1
dortmund indie	dortmund indie	1
kansas city hip hop	kansas city hip hop	1
kompa	kompa	1
axe	axe	1
norwegian pop	norwegian pop	1
sertanejo universitario	sertanejo universitario	1
musica campineira	musica campineira	1
detroit trap	detroit trap	1
punk ska	punk ska	1
latin talent show	latin talent show	1
indie pop rock	indie pop rock	1
rap tunisien	rap tunisien	1
bulgarian hip hop	bulgarian hip hop	1
spanish indie pop	spanish indie pop	1
hi-nrg	hi-nrg	1
cook islands pop	cook islands pop	1
pinoy r&b	pinoy r & b	1
albanian hip hop	albanian hip hop	1
forro gospel	forro gospel	1
virginia hip hop	virginia hip hop	1
argentine reggae	argentine reggae	1
detroit hip hop	detroit hip hop	1
morelos indie	morelos indie	1
indonesian edm	indonesian edm	1
essex indie	essex indie	1
ska mexicano	ska mexicano	1
classic russian rock	classic russian rock	1
musica sergipana	musica sergipana	1
ethiopian pop	ethiopian pop	1
pinoy trap	pinoy trap	1
london rap	london rap	1
experimental hip hop	experimental hip hop	1
buffalo hip hop	buffalo hip hop	1
rock baiano	rock baiano	1
minneapolis sound	minneapolis sound	1
indie rock italiano	indie rock italiano	1
ecuadorian alternative rock	ecuadorian alternative rock	1
greek pop	greek pop	1
swedish synth	swedish synth	1
flick hop	flick hop	1
german indie rock	german indie rock	1
miami indie	miami indie	1
iskelma	iskelma	1
pop reggaeton	pop reggaeton	1
new orleans rap	new orleans rap	1
london indie	london indie	1
serbian hip hop	serbian hip hop	1
khaliji	khaliji	1
hip hop tuga	hip hop tuga	1
deep neo-synthpop	deep neo-synthpop	1
rap cristao	rap cristao	1
deep tropical house	deep tropical house	1
manitoba country	manitoba country	1
indie soul	indie soul	1
edmonton indie	edmonton indie	1
south african trap	south african trap	1
cameroonian pop	cameroonian pop	1
latin afrobeat	latin afrobeat	1
dutch underground hip hop	dutch underground hip hop	1
conscious hip hop	conscious hip hop	1
magyar mulatos	magyar mulatos	1
pinoy hip hop	pinoy hip hop	1
flint hip hop	flint hip hop	1
egyptian hip hop	egyptian hip hop	1
tarantella	tarantella	1
minnesota hip hop	minnesota hip hop	1
bangladeshi rock	bangladeshi rock	1
trap soul	trap soul	1
alabama rap	alabama rap	1
oktoberfest	oktoberfest	1
naija worship	naija worship	1
gabonese pop	gabonese pop	1
alternative hip hop	alternative hip hop	1
samba reggae	samba reggae	1
deep eurodance	deep eurodance	1
west coast reggae	west coast reggae	1
old school nederhop	old school nederhop	1
euskal rock	euskal rock	1
toronto rap	toronto rap	1
greek trap	greek trap	1
uk alternative hip hop	uk alternative hip hop	1
euroska	euroska	1
macedonian indie	macedonian indie	1
philly rap	philly rap	1
arab trap	arab trap	1
hip hop	hip hop	1
brega romantico	brega romantico	1
surinamese pop	surinamese pop	1
electroclash	electroclash	1
zillertal	zillertal	1
ukrainian hip hop	ukrainian hip hop	1
swedish indie pop	swedish indie pop	1
rap conscient	rap conscient	1
malayalam worship	malayalam worship	1
pop flamenco	pop flamenco	1
french folk pop	french folk pop	1
reunion pop	reunion pop	1
romanian indie	romanian indie	1
nyc rap	nyc rap	1
bass trip	bass trip	1
latin worship	latin worship	1
gothenburg hip hop	gothenburg hip hop	1
classic malaysian pop	classic malaysian pop	1
turkish punk	turkish punk	1
cuarteto	cuarteto	1
channel islands indie	channel islands indie	1
fake	fake	1
catstep	catstep	1
sertanejo	sertanejo	1
afghan pop	afghan pop	1
dangdut remix	dangdut remix	1
rap maroc	rap maroc	1
southern soul blues	southern soul blues	1
manchester hip hop	manchester hip hop	1
uk dance	uk dance	1
rai	rai	1
zouk	zouk	1
p funk	p funk	1
lancashire indie	lancashire indie	1
outer hip hop	outer hip hop	1
okinawan folk	okinawan folk	1
esperanto	esperanto	1
kabyle	kabyle	1
rock andaluz	rock andaluz	1
popwave	popwave	1
cuban alternative	cuban alternative	1
punjabi pop	punjabi pop	1
thai trap	thai trap	1
steampunk	steampunk	1
twee indie pop	twee indie pop	1
bergamo indie	bergamo indie	1
indonesian pop punk	indonesian pop punk	1
deep southern trap	deep southern trap	1
trip hop	trip hop	1
orquestas de galicia	orquestas de galicia	1
jawaiian	jawaiian	1
cypriot pop	cypriot pop	1
manso indie	manso indie	1
underground rap	underground rap	1
early synthpop	early synthpop	1
mandopop	mandopop	1
azeri rap	azeri rap	1
finnish idol pop	finnish idol pop	1
bubblegum dance	bubblegum dance	1
classic dutch pop	classic dutch pop	1
tollywood	tollywood	1
indonesian psychedelia	indonesian psychedelia	1
nz reggae	nz reggae	1
viral trap	viral trap	1
deep classic garage rock	deep classic garage rock	1
disco polo	disco polo	1
glitch hop	glitch hop	1
haitian dance	haitian dance	1
r&b en espanol	r & b en espanol	1
stomp and whittle	stomp and whittle	1
australian indigenous	australian indigenous	1
musica paraibana	musica paraibana	1
uk drill	uk drill	1
taiwan indie	taiwan indie	1
png pop	png pop	1
hong kong rock	hong kong rock	1
indie emo	indie emo	1
polish post-punk	polish post-punk	1
solomon islands pop	solomon islands pop	1
j-division	j-division	1
brit funk	brit funk	1
hungarian indie	hungarian indie	1
oakland hip hop	oakland hip hop	1
flamenco fusion	flamenco fusion	1
indonesian rock	indonesian rock	1
rap ecuatoriano	rap ecuatoriano	1
swiss alternative rock	swiss alternative rock	1
deep freestyle	deep freestyle	1
polish alternative rock	polish alternative rock	1
swedish underground rap	swedish underground rap	1
coldwave	coldwave	1
mississippi hip hop	mississippi hip hop	1
traditional funk	traditional funk	1
swedish trap	swedish trap	1
indie tucumano	indie tucumano	1
hip hop boliviano	hip hop boliviano	1
afrobeat brasileiro	afrobeat brasileiro	1
slovenian rock	slovenian rock	1
belgian edm	belgian edm	1
cape breton indie	cape breton indie	1
balkan brass	balkan brass	1
medimeisterschaften	medimeisterschaften	1
grime brasileiro	grime brasileiro	1
dubstep product	dubstep product	1
igbo worship	igbo worship	1
pinoy alternative rap	pinoy alternative rap	1
sevilla indie	sevilla indie	1
austrian indie	austrian indie	1
harlem hip hop	harlem hip hop	1
brazilian blues	brazilian blues	1
alberta hip hop	alberta hip hop	1
dutch rock	dutch rock	1
new french touch	new french touch	1
red dirt	red dirt	1
nepali pop	nepali pop	1
nice indie	nice indie	1
dirty south rap	dirty south rap	1
rock caipira	rock caipira	1
post-disco	post-disco	1
one-person band	one-person band	1
malawian pop	malawian pop	1
musica occitana	musica occitana	1
dutch indie	dutch indie	1
go-go	go-go	1
oaxaca indie	oaxaca indie	1
houston rap	houston rap	1
birmingham hip hop	birmingham hip hop	1
west coast trap	west coast trap	1
rap maromba	rap maromba	1
pop urbaine	pop urbaine	1
samoan pop	samoan pop	1
trap chileno	trap chileno	1
classic indo pop	classic indo pop	1
indie nordeste argentino	indie nordeste argentino	1
french hip hop	french hip hop	1
bay area hip hop	bay area hip hop	1
classic schlager	classic schlager	1
modern funk	modern funk	1
scottish new wave	scottish new wave	1
nigerian pop	nigerian pop	1
rock tico	rock tico	1
reggae en espanol	reggae en espanol	1
rap algerien	rap algerien	1
iowa hip hop	iowa hip hop	1
rock catala	rock catala	1
chattanooga indie	chattanooga indie	1
cumbia surena	cumbia surena	1
finnish indie	finnish indie	1
deep indie pop	deep indie pop	1
japanese singer-songwriter	japanese singer-songwriter	1
stomp pop	stomp pop	1
singaporean hip hop	singaporean hip hop	1
fussball	fussball	1
afroswing	afroswing	1
chopped and screwed	chopped and screwed	1
spanish blues	spanish blues	1
minimal wave	minimal wave	1
musique acadienne	musique acadienne	1
scam rap	scam rap	1
devon indie	devon indie	1
brazilian hip hop	brazilian hip hop	1
indie r&b	indie r & b	1
complextro	complextro	1
sardinia indie	sardinia indie	1
ambeat	ambeat	1
latin ska	latin ska	1
indie valenciana	indie valenciana	1
semba	semba	1
rock drums	rock drums	1
hawaiian hip hop	hawaiian hip hop	1
brega	brega	1
brazilian soul	brazilian soul	1
neo r&b	neo r & b	1
spanish hip hop	spanish hip hop	1
bahai	bahai	1
jewish pop	jewish pop	1
neapolitan funk	neapolitan funk	1
south african country	south african country	1
rap marseille	rap marseille	1
austin hip hop	austin hip hop	1
new jersey rap	new jersey rap	1
musica per bambini	musica per bambini	1
belgian blues	belgian blues	1
perth indie	perth indie	1
arab alternative	arab alternative	1
mainland chinese pop	mainland chinese pop	1
rap underground espanol	rap underground espanol	1
meme rap	meme rap	1
boom bap	boom bap	1
indonesian city pop	indonesian city pop	1
quiet storm	quiet storm	1
dfw rap	dfw rap	1
boy pop	boy pop	1
downtempo	downtempo	1
kurdish rock	kurdish rock	1
dallas indie	dallas indie	1
rwandan hip hop	rwandan hip hop	1
jamtronica	jamtronica	1
israeli pop	israeli pop	1
musique comorienne	musique comorienne	1
bongo flava	bongo flava	1
baja indie	baja indie	1
garifuna folk	garifuna folk	1
queercore	queercore	1
r&b argentino	r & b argentino	1
wrock	wrock	1
funk evangelico	funk evangelico	1
lafayette indie	lafayette indie	1
hungarian hip hop	hungarian hip hop	1
chillwave	chillwave	1
bahamian pop	bahamian pop	1
big beat	big beat	1
indie catala	indie catala	1
birthday	birthday	1
nouvelle chanson francaise	nouvelle chanson francaise	1
new hampshire indie	new hampshire indie	1
balkan hip hop	balkan hip hop	1
indonesian punk	indonesian punk	1
balkan trap	balkan trap	1
pop peruano	pop peruano	1
wuhan indie	wuhan indie	1
permanent wave	permanent wave	1
hindi hip hop	hindi hip hop	1
deep rai	deep rai	1
dresden indie	dresden indie	1
cali rap	cali rap	1
musica costarricense	musica costarricense	1
indie rockism	indie rockism	1
poznan indie	poznan indie	1
ghent indie	ghent indie	1
japanese post-punk	japanese post-punk	1
trap catala	trap catala	1
tecnobrega	tecnobrega	1
thai folk pop	thai folk pop	1
indie tico	indie tico	1
st louis rap	st louis rap	1
bhangra	bhangra	1
lesotho traditional	lesotho traditional	1
italian indie pop	italian indie pop	1
dutch hip hop	dutch hip hop	1
salay	salay	1
russian underground rap	russian underground rap	1
twin cities indie	twin cities indie	1
groove gospel	groove gospel	1
luxembourgian hip hop	luxembourgian hip hop	1
rap feminino nacional	rap feminino nacional	1
ninja	ninja	1
german dance	german dance	1
deep vocal house	deep vocal house	1
tamil pop	tamil pop	1
indie napoletano	indie napoletano	1
israeli indie	israeli indie	1
cumbia pop	cumbia pop	1
musica calabrese	musica calabrese	1
wu fam	wu fam	1
kingston on indie	kingston on indie	1
sandalwood	sandalwood	1
eritrean pop	eritrean pop	1
rap tico	rap tico	1
halifax indie	halifax indie	1
portuguese indie rock	portuguese indie rock	1
belgian indie	belgian indie	1
nigerian hip hop	nigerian hip hop	1
cumbia chilena	cumbia chilena	1
musik anak-anak	musik anak-anak	1
warrington indie	warrington indie	1
asheville indie	asheville indie	1
danish indie	danish indie	1
nu-cumbia	nu-cumbia	1
san diego rap	san diego rap	1
livetronica	livetronica	1
haitian gospel	haitian gospel	1
tennessee hip hop	tennessee hip hop	1
portuguese indie	portuguese indie	1
deep hardcore	deep hardcore	1
swedish alternative rock	swedish alternative rock	1
trap mexicano	trap mexicano	1
san marcos tx indie	san marcos tx indie	1
dmv rap	dmv rap	1
finnish electro	finnish electro	1
neo-traditional country	neo-traditional country	1
italian ska	italian ska	1
portsmouth indie	portsmouth indie	1
reggae mexicano	reggae mexicano	1
stuttgart indie	stuttgart indie	1
deep contemporary country	deep contemporary country	1
rock sul-mato-grossense	rock sul-mato-grossense	1
azontobeats	azontobeats	1
deep christian rock	deep christian rock	1
experimental bass	experimental bass	1
baltimore hip hop	baltimore hip hop	1
rock viet	rock viet	1
samba gospel	samba gospel	1
dabke	dabke	1
brazilian reggae	brazilian reggae	1
narodna muzika	narodna muzika	1
beach music	beach music	1
ritmo kombina	ritmo kombina	1
singaporean pop	singaporean pop	1
indie platense	indie platense	1
underground latin hip hop	underground latin hip hop	1
belly dance	belly dance	1
beninese pop	beninese pop	1
northern irish indie	northern irish indie	1
austindie	austindie	1
trap queen	trap queen	1
irish trap	irish trap	1
afro dancehall	afro dancehall	1
czech rock	czech rock	1
isle of wight indie	isle of wight indie	1
abstract beats	abstract beats	1
austropop	austropop	1
basel indie	basel indie	1
rap sardegna	rap sardegna	1
maghreb	maghreb	1
french dub	french dub	1
electronica	electronica	1
salsa cristiana	salsa cristiana	1
jazztronica	jazztronica	1
belo horizonte indie	belo horizonte indie	1
benga	benga	1
deep funk	deep funk	1
slovak indie	slovak indie	1
brazilian gospel	brazilian gospel	1
turkish singer-songwriter	turkish singer-songwriter	1
firenze indie	firenze indie	1
french pop	french pop	1
ann arbor indie	ann arbor indie	1
rap criolo	rap criolo	1
crunk	crunk	1
montreal indie	montreal indie	1
blues latinoamericano	blues latinoamericano	1
quebec indie	quebec indie	1
makossa	makossa	1
belgian hip hop	belgian hip hop	1
new brunswick indie	new brunswick indie	1
instrumental grime	instrumental grime	1
classic nz pop	classic nz pop	1
limerick indie	limerick indie	1
san antonio rap	san antonio rap	1
oth indie	oth indie	1
queens hip hop	queens hip hop	1
ottawa rap	ottawa rap	1
dc indie	dc indie	1
asbury park indie	asbury park indie	1
moombahton	moombahton	1
turkish rock	turkish rock	1
vlaamse kinderliedje	vlaamse kinderliedje	1
gangster rap	gangster rap	1
canadian indigenous hip hop	canadian indigenous hip hop	1
auckland indie	auckland indie	1
russian post-punk	russian post-punk	1
afropop	afropop	1
turkish alternative rock	turkish alternative rock	1
german singer-songwriter	german singer-songwriter	1
lithuanian indie	lithuanian indie	1
indie deutschrap	indie deutschrap	1
hyphy	hyphy	1
vocal trance	vocal trance	1
russian alternative	russian alternative	1
serbian indie	serbian indie	1
blues-rock guitar	blues-rock guitar	1
uk dancehall	uk dancehall	1
brighton indie	brighton indie	1
brostep	brostep	1
kurdish pop	kurdish pop	1
turntablism	turntablism	1
italian reggae	italian reggae	1
rap latina	rap latina	1
malayalam hip hop	malayalam hip hop	1
luxembourgian indie	luxembourgian indie	1
rock potiguar	rock potiguar	1
deep italo disco	deep italo disco	1
rock alternativo brasileiro	rock alternativo brasileiro	1
sinaloa indie	sinaloa indie	1
musical advocacy	musical advocacy	1
italian disco	italian disco	1
rap rock	rap rock	1
phonk	phonk	1
rap kreyol	rap kreyol	1
nu jazz	nu jazz	1
acid jazz	acid jazz	1
rap montrealais	rap montrealais	1
filter house	filter house	1
j-rock	j-rock	1
musica cearense	musica cearense	1
victoria bc indie	victoria bc indie	1
kawaii edm	kawaii edm	1
greek indie rock	greek indie rock	1
eurobeat	eurobeat	1
antilliaanse rap	antilliaanse rap	1
bayerischer rap	bayerischer rap	1
guinean pop	guinean pop	1
italian rockabilly	italian rockabilly	1
ontario indie	ontario indie	1
rap baiano	rap baiano	1
country dawn	country dawn	1
rock curitibano	rock curitibano	1
cantopop	cantopop	1
vanuatu music	vanuatu music	1
battle rap	battle rap	1
zouglou	zouglou	1
indie fuzzpop	indie fuzzpop	1
carnaval cadiz	carnaval cadiz	1
philly soul	philly soul	1
german reggae	german reggae	1
irish pop	irish pop	1
j-acoustic	j-acoustic	1
stl indie	stl indie	1
argentine hip hop	argentine hip hop	1
corridos cristianos	corridos cristianos	1
bassline	bassline	1
flamenco urbano	flamenco urbano	1
north east england indie	north east england indie	1
gengetone	gengetone	1
german alternative rock	german alternative rock	1
rockabilly en espanol	rockabilly en espanol	1
filthstep	filthstep	1
georgian alternative	georgian alternative	1
karadeniz halk muzigi	karadeniz halk muzigi	1
dakke dak	dakke dak	1
wonky	wonky	1
dirty texas rap	dirty texas rap	1
rock quebecois	rock quebecois	1
reggaeton mexicano	reggaeton mexicano	1
athens indie	athens indie	1
indie siciliano	indie siciliano	1
hungarian underground rap	hungarian underground rap	1
northamptonshire indie	northamptonshire indie	1
minneapolis indie	minneapolis indie	1
candombe	candombe	1
oyun havasi	oyun havasi	1
colombian hip hop	colombian hip hop	1
twoubadou	twoubadou	1
rochester mn indie	rochester mn indie	1
ok indie	ok indie	1
taiwan rock	taiwan rock	1
basshall	basshall	1
rock catracho	rock catracho	1
polish indie rock	polish indie rock	1
musica alagoana	musica alagoana	1
afro psych	afro psych	1
icelandic pop	icelandic pop	1
funana	funana	1
comedy rap	comedy rap	1
czech indie	czech indie	1
south sudanese pop	south sudanese pop	1
brooklyn indie	brooklyn indie	1
normal indie	normal indie	1
czech pop	czech pop	1
canadian indie	canadian indie	1
kentucky hip hop	kentucky hip hop	1
romanian rock	romanian rock	1
leicester indie	leicester indie	1
dansktop	dansktop	1
australian indie rock	australian indie rock	1
fijian pop	fijian pop	1
pop catracho	pop catracho	1
swedish blues	swedish blues	1
panamanian pop	panamanian pop	1
brockton hip hop	brockton hip hop	1
sinhala pop	sinhala pop	1
deep northern soul	deep northern soul	1
serbian alternative rock	serbian alternative rock	1
mexican hip hop	mexican hip hop	1
chamame brasilero	chamame brasilero	1
underground power pop	underground power pop	1
norwegian rock	norwegian rock	1
ny roots	ny roots	1
phoenix indie	phoenix indie	1
german trap	german trap	1
vintage reggae	vintage reggae	1
arkansas hip hop	arkansas hip hop	1
taiwanese pop	taiwanese pop	1
ottawa indie	ottawa indie	1
early french punk	early french punk	1
liberian pop	liberian pop	1
swedish reggae	swedish reggae	1
electro dub	electro dub	1
finnish trap	finnish trap	1
roots americana	roots americana	1
nuevo folklore argentino	nuevo folklore argentino	1
modern downshift	modern downshift	1
kenyan hip hop	kenyan hip hop	1
hull indie	hull indie	1
classic italian folk pop	classic italian folk pop	1
windsor on indie	windsor on indie	1
spanish rockabilly	spanish rockabilly	1
gambian pop	gambian pop	1
anime	anime	1
classic swedish pop	classic swedish pop	1
spanish noise pop	spanish noise pop	1
neotango	neotango	1
cantaditas	cantaditas	1
concepcion indie	concepcion indie	1
wyoming indie	wyoming indie	1
grunge pop	grunge pop	1
baton rouge rap	baton rouge rap	1
chinese indie rock	chinese indie rock	1
spanish reggae	spanish reggae	1
rap francais	rap francais	1
pakistani indie	pakistani indie	1
armenian folk	armenian folk	1
denver indie	denver indie	1
cumbia boliviana	cumbia boliviana	1
musica potiguar	musica potiguar	1
forro	forro	1
gothenburg indie	gothenburg indie	1
soft rock	soft rock	1
birmingham indie	birmingham indie	1
indonesian r&b	indonesian r & b	1
lexington ky indie	lexington ky indie	1
power blues-rock	power blues-rock	1
sega	sega	1
coupe decale	coupe decale	1
liverpool indie	liverpool indie	1
granada indie	granada indie	1
folk-pop	folk-pop	1
african gospel	african gospel	1
bounce	bounce	1
latintronica	latintronica	1
worcester ma indie	worcester ma indie	1
rap espanol	rap espanol	1
chinese indie	chinese indie	1
canadian indigenous	canadian indigenous	1
slc indie	slc indie	1
bloco	bloco	1
nederlandse hardstyle	nederlandse hardstyle	1
música pitiusa	música pitiusa	1
montana indie	montana indie	1
j-idol	j-idol	1
kc indie	kc indie	1
fort worth indie	fort worth indie	1
italian pop	italian pop	1
georgian pop	georgian pop	1
zolo	zolo	1
classic canadian rock	classic canadian rock	1
florida rap	florida rap	1
arabesk	arabesk	1
morna	morna	1
kansas indie	kansas indie	1
vancouver indie	vancouver indie	1
trinidadian reggae	trinidadian reggae	1
japanese ska	japanese ska	1
grand rapids indie	grand rapids indie	1
reading indie	reading indie	1
anime latino	anime latino	1
irish rock	irish rock	1
cumbia villera	cumbia villera	1
rap chileno	rap chileno	1
deep filthstep	deep filthstep	1
burkinabe pop	burkinabe pop	1
ebm	ebm	1
otacore	otacore	1
eurodance	eurodance	1
dutch trap pop	dutch trap pop	1
south african rock	south african rock	1
modern southern rock	modern southern rock	1
seattle indie	seattle indie	1
soca	soca	1
british country	british country	1
palestinian pop	palestinian pop	1
icelandic rock	icelandic rock	1
finnish blues	finnish blues	1
native american contemporary	native american contemporary	1
canadian ccm	canadian ccm	1
manitoba indie	manitoba indie	1
nashville indie	nashville indie	1
japanese alternative rock	japanese alternative rock	1
yacht rock	yacht rock	1
norwegian indie	norwegian indie	1
tulsa indie	tulsa indie	1
bath indie	bath indie	1
knoxville indie	knoxville indie	1
country quebecois	country quebecois	1
albany ny indie	albany ny indie	1
columbus ohio indie	columbus ohio indie	1
indiana indie	indiana indie	1
hardcore hip hop	hardcore hip hop	1
christian alternative rock	christian alternative rock	1
trap brasileiro	trap brasileiro	1
charlotte nc indie	charlotte nc indie	1
cancion infantil mexicana	cancion infantil mexicana	1
chicago indie	chicago indie	1
musica hondurena	musica hondurena	1
futurepop	futurepop	1
musica nicaraguense	musica nicaraguense	1
reggae tico	reggae tico	1
christchurch indie	christchurch indie	1
deep disco	deep disco	1
chicano rap	chicano rap	1
grave wave	grave wave	1
svensk indie	svensk indie	1
south african gospel	south african gospel	1
australian alternative rock	australian alternative rock	1
pagode	pagode	1
vapor trap	vapor trap	1
neo honky tonk	neo honky tonk	1
trap argentino	trap argentino	1
cumbia andina mexicana	cumbia andina mexicana	1
dark wave	dark wave	1
modern uplift	modern uplift	1
indie quebecois	indie quebecois	1
orlando indie	orlando indie	1
musica pernambucana	musica pernambucana	1
saskatchewan indie	saskatchewan indie	1
canadian country	canadian country	1
magyar trap	magyar trap	1
bouncy house	bouncy house	1
rap salvadoreno	rap salvadoreno	1
punta	punta	1
little rock indie	little rock indie	1
swedish post-punk	swedish post-punk	1
mongolian hip hop	mongolian hip hop	1
post-punk brasileiro	post-punk brasileiro	1
aggro chileno	aggro chileno	1
belgian dance	belgian dance	1
indie folk italiano	indie folk italiano	1
hampton roads indie	hampton roads indie	1
french rock	french rock	1
reggae fusion	reggae fusion	1
future house	future house	1
funk metal	funk metal	1
tahitian	tahitian	1
funk	funk	1
traditional reggae	traditional reggae	1
hip hop galsen	hip hop galsen	1
keroncong	keroncong	1
lawrence ks indie	lawrence ks indie	1
indian edm	indian edm	1
welsh indie	welsh indie	1
south carolina indie	south carolina indie	1
jazz rap	jazz rap	1
samba-enredo	samba-enredo	1
praise	praise	1
malaysian mandopop	malaysian mandopop	1
indie rock	indie rock	1
scottish rock	scottish rock	1
molam	molam	1
rap conciencia	rap conciencia	1
lebanese indie	lebanese indie	1
neue deutsche harte	neue deutsche harte	1
world chill	world chill	1
trap latino	trap latino	1
dublin indie	dublin indie	1
slovenian hip hop	slovenian hip hop	1
arkansas indie	arkansas indie	1
arab groove	arab groove	1
polish blues	polish blues	1
rajasthani pop	rajasthani pop	1
mezmur	mezmur	1
modern alternative rock	modern alternative rock	1
nephop	nephop	1
southampton indie	southampton indie	1
musica maranhense	musica maranhense	1
oromo pop	oromo pop	1
alternative roots rock	alternative roots rock	1
kentucky indie	kentucky indie	1
contemporary gospel	contemporary gospel	1
east coast hip hop	east coast hip hop	1
brazilian boogie	brazilian boogie	1
modern ska punk	modern ska punk	1
sevdah	sevdah	1
samba-rock	samba-rock	1
twee pop	twee pop	1
gumbe	gumbe	1
classic greek rock	classic greek rock	1
medieval rock	medieval rock	1
electro swing	electro swing	1
classic sinhala pop	classic sinhala pop	1
reggaeton chileno	reggaeton chileno	1
hindi worship	hindi worship	1
witch house	witch house	1
heartland rock	heartland rock	1
springfield mo indie	springfield mo indie	1
vbs	vbs	1
trad quebecois	trad quebecois	1
afrofuturism	afrofuturism	1
swedish dancehall	swedish dancehall	1
funk melody	funk melody	1
disney portugues brasil	disney portugues brasil	1
rochester ny indie	rochester ny indie	1
melodic rap	melodic rap	1
chaabi marocain	chaabi marocain	1
fort wayne indie	fort wayne indie	1
trap venezolano	trap venezolano	1
big room	big room	1
azonto	azonto	1
memphis hip hop	memphis hip hop	1
kwaito house	kwaito house	1
zapstep	zapstep	1
calgary indie	calgary indie	1
canadian rock	canadian rock	1
canadian electronic	canadian electronic	1
sacramento hip hop	sacramento hip hop	1
ghanaian pop	ghanaian pop	1
classic icelandic pop	classic icelandic pop	1
dong-yo	dong-yo	1
psychedelic pop	psychedelic pop	1
dutch indie rock	dutch indie rock	1
polish electronica	polish electronica	1
ragga jungle	ragga jungle	1
adelaide indie	adelaide indie	1
neue deutsche todeskunst	neue deutsche todeskunst	1
german ccm	german ccm	1
galician rock	galician rock	1
hiplife	hiplife	1
goralski	goralski	1
glitch pop	glitch pop	1
rap paraense	rap paraense	1
purple sound	purple sound	1
omaha indie	omaha indie	1
hard chime	hard chime	1
baton rouge indie	baton rouge indie	1
deep g funk	deep g funk	1
rock urbano mexicano	rock urbano mexicano	1
greek indie	greek indie	1
deep gothic post-punk	deep gothic post-punk	1
sonora indie	sonora indie	1
folk punk	folk punk	1
c64	c64	1
classic danish rock	classic danish rock	1
musica triste brasileira	musica triste brasileira	1
swiss worship	swiss worship	1
derry indie	derry indie	1
modern blues rock	modern blues rock	1
indonesian jazz	indonesian jazz	1
swiss singer-songwriter	swiss singer-songwriter	1
industrial rock	industrial rock	1
cambodian rock	cambodian rock	1
trap tuga	trap tuga	1
sovietwave	sovietwave	1
ethereal gothic	ethereal gothic	1
east anglia indie	east anglia indie	1
venezuelan hip hop	venezuelan hip hop	1
rva indie	rva indie	1
kids dance party	kids dance party	1
uk rockabilly	uk rockabilly	1
indorock	indorock	1
israeli rock	israeli rock	1
cincinnati rap	cincinnati rap	1
ambient fusion	ambient fusion	1
musica piauiense	musica piauiense	1
tekk	tekk	1
v-pop	v-pop	1
deep indie singer-songwriter	deep indie singer-songwriter	1
scratch	scratch	1
denpa-kei	denpa-kei	1
tamaulipas indie	tamaulipas indie	1
ugandan pop	ugandan pop	1
new york drill	new york drill	1
nottingham indie	nottingham indie	1
welsh rock	welsh rock	1
art pop	art pop	1
rio grande do sul indie	rio grande do sul indie	1
rap metal espanol	rap metal espanol	1
memphis americana	memphis americana	1
edinburgh indie	edinburgh indie	1
bandinhas	bandinhas	1
glasgow indie	glasgow indie	1
toronto indie	toronto indie	1
dubstep	dubstep	1
rock en asturiano	rock en asturiano	1
mariachi cristiano	mariachi cristiano	1
slovenian indie	slovenian indie	1
parody	parody	1
glam rock	glam rock	1
kleinkunst	kleinkunst	1
halftime dnb	halftime dnb	1
trot	trot	1
british children's music	british children 's music	1
norges stemme	norges stemme	1
brooklyn drill	brooklyn drill	1
alternative hardcore	alternative hardcore	1
pittsburgh indie	pittsburgh indie	1
cumbia ranchera	cumbia ranchera	1
jersey club	jersey club	1
nederpop	nederpop	1
novos talentos brasileiros	novos talentos brasileiros	1
shimmer psych	shimmer psych	1
belgian indie rock	belgian indie rock	1
plunderphonics	plunderphonics	1
modern mod	modern mod	1
adoracao	adoracao	1
vaikiskos dainos	vaikiskos dainos	1
breakcore	breakcore	1
south african jazz	south african jazz	1
german blues	german blues	1
cambridgeshire indie	cambridgeshire indie	1
uk funky	uk funky	1
west-vlaamse hip hop	west-vlaamse hip hop	1
ghanaian hip hop	ghanaian hip hop	1
broken beat	broken beat	1
oxford indie	oxford indie	1
tribute	tribute	1
finnish new wave	finnish new wave	1
dutch trap	dutch trap	1
galego	galego	1
streektaal	streektaal	1
channel pop	channel pop	1
opm	opm	1
christian music	christian music	1
bboy	bboy	1
norwegian blues	norwegian blues	1
power pop	power pop	1
bay area indie	bay area indie	1
italian blues	italian blues	1
ska	ska	1
neo-rockabilly	neo-rockabilly	1
street band	street band	1
rotterdam indie	rotterdam indie	1
j-core	j-core	1
finnish rockabilly	finnish rockabilly	1
lincoln ne indie	lincoln ne indie	1
english indie rock	english indie rock	1
cumbia peruana	cumbia peruana	1
oakland indie	oakland indie	1
electro jazz	electro jazz	1
thai folk	thai folk	1
oshare kei	oshare kei	1
madchester	madchester	1
bikutsi	bikutsi	1
musica eletronica brasileira	musica eletronica brasileira	1
acoustic punk	acoustic punk	1
marrabenta	marrabenta	1
tempe indie	tempe indie	1
frankfurt indie	frankfurt indie	1
muzica copii	muzica copii	1
tape club	tape club	1
beatlesque	beatlesque	1
charlottesville indie	charlottesville indie	1
japanese jazz fusion	japanese jazz fusion	1
rock	rock	1
etherpop	etherpop	1
oslo indie	oslo indie	1
electro-industrial	electro-industrial	1
san diego indie	san diego indie	1
celtic rock	celtic rock	1
laiko	laiko	1
kikuyu gospel	kikuyu gospel	1
art punk	art punk	1
new mexico music	new mexico music	1
electro latino	electro latino	1
indonesian worship	indonesian worship	1
nz indie	nz indie	1
manchester indie	manchester indie	1
proto-techno	proto-techno	1
forro de favela	forro de favela	1
mbalax	mbalax	1
nova mpb	nova mpb	1
finnish reggae	finnish reggae	1
portland indie	portland indie	1
tex-mex	tex-mex	1
afro-funk	afro-funk	1
st petersburg fl indie	st petersburg fl indie	1
progressive electro house	progressive electro house	1
rhode island indie	rhode island indie	1
downtempo bass	downtempo bass	1
deep east coast hip hop	deep east coast hip hop	1
cornwall indie	cornwall indie	1
hungarian punk	hungarian punk	1
musica baiana	musica baiana	1
chinese experimental	chinese experimental	1
cardiff indie	cardiff indie	1
gainesville indie	gainesville indie	1
kindie rock	kindie rock	1
melodic dubstep	melodic dubstep	1
rap euskera	rap euskera	1
post-disco soul	post-disco soul	1
japanese math rock	japanese math rock	1
villancicos	villancicos	1
austin americana	austin americana	1
neue volksmusik	neue volksmusik	1
german worship	german worship	1
south dakota indie	south dakota indie	1
progressive house	progressive house	1
west coast rap	west coast rap	1
electro bailando	electro bailando	1
funk carioca	funk carioca	1
uk post-punk	uk post-punk	1
japanese rockabilly	japanese rockabilly	1
newcastle nsw indie	newcastle nsw indie	1
boston indie	boston indie	1
maine indie	maine indie	1
syrian pop	syrian pop	1
irish indie rock	irish indie rock	1
sydney indie	sydney indie	1
deep soft rock	deep soft rock	1
german rockabilly	german rockabilly	1
dark electro	dark electro	1
greek rock	greek rock	1
waiata maori	waiata maori	1
wyoming roots	wyoming roots	1
tamaulipas rap	tamaulipas rap	1
chamber psych	chamber psych	1
australian blues	australian blues	1
classic uk pop	classic uk pop	1
russian ccm	russian ccm	1
magyar	magyar	1
j-poprock	j-poprock	1
c86	c86	1
commons	commons	1
folclore portugues	folclore portugues	1
indie emo rock	indie emo rock	1
jangle pop	jangle pop	1
spanish modern rock	spanish modern rock	1
atl trap	atl trap	1
hip hop cubano	hip hop cubano	1
cantautor	cantautor	1
western mass indie	western mass indie	1
deep latin christian	deep latin christian	1
modern reggae	modern reggae	1
stockholm indie	stockholm indie	1
bronx hip hop	bronx hip hop	1
latin hip hop	latin hip hop	1
dutch blues	dutch blues	1
country	country	1
rare groove	rare groove	1
piano rock	piano rock	1
deep big room	deep big room	1
indie psych-pop	indie psych-pop	1
forro tradicional	forro tradicional	1
antilliaanse folklore	antilliaanse folklore	1
australian rockabilly	australian rockabilly	1
ska punk	ska punk	1
christian dance	christian dance	1
nz christian	nz christian	1
orebro indie	orebro indie	1
sacramento indie	sacramento indie	1
greek swing	greek swing	1
indy indie	indy indie	1
britpop	britpop	1
second line	second line	1
buffalo ny indie	buffalo ny indie	1
manele	manele	1
dutch trance	dutch trance	1
synth punk	synth punk	1
cumbia santafesina	cumbia santafesina	1
brazilian indie rock	brazilian indie rock	1
cancoes infantis	cancoes infantis	1
dominican pop	dominican pop	1
virginia indie	virginia indie	1
downtempo fusion	downtempo fusion	1
indie garage rock	indie garage rock	1
nl folk	nl folk	1
acoustic pop	acoustic pop	1
rock gospel brasileiro	rock gospel brasileiro	1
motown	motown	1
world	world	1
virgin islands reggae	virgin islands reggae	1
san antonio indie	san antonio indie	1
gothic post-punk	gothic post-punk	1
korean superband	korean superband	1
demoscene	demoscene	1
reggaeton colombiano	reggaeton colombiano	1
hard rock brasileiro	hard rock brasileiro	1
ecuadorian pop	ecuadorian pop	1
industrial	industrial	1
blues band	blues band	1
rap paraguayo	rap paraguayo	1
newfoundland indie	newfoundland indie	1
sevillanas	sevillanas	1
jewish a capella	jewish a capella	1
dark cabaret	dark cabaret	1
neon pop punk	neon pop punk	1
classic finnish rock	classic finnish rock	1
indonesian alternative rock	indonesian alternative rock	1
jangle rock	jangle rock	1
michigan indie	michigan indie	1
experimental club	experimental club	1
traditional soul	traditional soul	1
swedish rockabilly	swedish rockabilly	1
musica etnica	musica etnica	1
singaporean mandopop	singaporean mandopop	1
houston indie	houston indie	1
bedroom pop	bedroom pop	1
zydeco	zydeco	1
weightless	weightless	1
musique traditionnelle comorienne	musique traditionnelle comorienne	1
mississippi indie	mississippi indie	1
smooth saxophone	smooth saxophone	1
estonian rock	estonian rock	1
malmo indie	malmo indie	1
lds youth	lds youth	1
tibetan pop	tibetan pop	1
breakbeat	breakbeat	1
estonian indie	estonian indie	1
japanese dream pop	japanese dream pop	1
derby indie	derby indie	1
scottish indie	scottish indie	1
baltimore indie	baltimore indie	1
art rock	art rock	1
chinese electronic	chinese electronic	1
popping	popping	1
pagode novo	pagode novo	1
santa fe indie	santa fe indie	1
afrikaans folk	afrikaans folk	1
british indie rock	british indie rock	1
brazilian ccm	brazilian ccm	1
guam indie	guam indie	1
tropical	tropical	1
missouri indie	missouri indie	1
experimental pop	experimental pop	1
louisville indie	louisville indie	1
dundee indie	dundee indie	1
melbourne indie	melbourne indie	1
rock nacional	rock nacional	1
maloya	maloya	1
connecticut indie	connecticut indie	1
karaoke	karaoke	1
classic cantopop	classic cantopop	1
anadolu rock	anadolu rock	1
grimewave	grimewave	1
pei indie	pei indie	1
alabama indie	alabama indie	1
baltic folk	baltic folk	1
neo-singer-songwriter	neo-singer-songwriter	1
funk das antigas	funk das antigas	1
bernu dziesmas	bernu dziesmas	1
japanese indie folk	japanese indie folk	1
olympia wa indie	olympia wa indie	1
electra	electra	1
milwaukee indie	milwaukee indie	1
indiecoustica	indiecoustica	1
danish electronic	danish electronic	1
post-punk	post-punk	1
italian post punk	italian post punk	1
garage punk blues	garage punk blues	1
maskandi	maskandi	1
indie jazz	indie jazz	1
no wave	no wave	1
cumbia sonidera	cumbia sonidera	1
desi pop	desi pop	1
pub rock	pub rock	1
grupera	grupera	1
canadian blues	canadian blues	1
classic israeli pop	classic israeli pop	1
neo-industrial rock	neo-industrial rock	1
turkish metal	turkish metal	1
new jersey indie	new jersey indie	1
classic norwegian pop	classic norwegian pop	1
experimental indie	experimental indie	1
dalarna indie	dalarna indie	1
norsk lovsang	norsk lovsang	1
dancehall	dancehall	1
swiss reggae	swiss reggae	1
uk garage	uk garage	1
melbourne bounce international	melbourne bounce international	1
swedish indie rock	swedish indie rock	1
mexican edm	mexican edm	1
neo-proto	neo-proto	1
alaska indie	alaska indie	1
jacksonville indie	jacksonville indie	1
comic metal	comic metal	1
mexican electronic	mexican electronic	1
modern jangle pop	modern jangle pop	1
polish punk	polish punk	1
animal singing	animal singing	1
mod revival	mod revival	1
danish rock	danish rock	1
rap calme	rap calme	1
apostolic worship	apostolic worship	1
reggaeton flow	reggaeton flow	1
texas country	texas country	1
ccm	ccm	1
bass music	bass music	1
persian alternative	persian alternative	1
lithuanian folk	lithuanian folk	1
modern blues	modern blues	1
german post-punk	german post-punk	1
chinese folk	chinese folk	1
okc indie	okc indie	1
atlanta indie	atlanta indie	1
deep new americana	deep new americana	1
riddim	riddim	1
kaseko	kaseko	1
cincinnati indie	cincinnati indie	1
industrial metal	industrial metal	1
electro trash	electro trash	1
german indie folk	german indie folk	1
afrobeat	afrobeat	1
psybass	psybass	1
disney espanol	disney espanol	1
discofox	discofox	1
japanese indie rock	japanese indie rock	1
lilith	lilith	1
singaporean electronic	singaporean electronic	1
nashville americana	nashville americana	1
deep indian pop	deep indian pop	1
reggaeton	reggaeton	1
london on indie	london on indie	1
musica infantil	musica infantil	1
nz electronic	nz electronic	1
sertanejo tradicional	sertanejo tradicional	1
newcastle indie	newcastle indie	1
album rock	album rock	1
danish electro	danish electro	1
dark electro-industrial	dark electro-industrial	1
cuban electronic	cuban electronic	1
deep smooth jazz	deep smooth jazz	1
canberra indie	canberra indie	1
dutch americana	dutch americana	1
northern soul	northern soul	1
christian punk	christian punk	1
baroque pop	baroque pop	1
galway indie	galway indie	1
african reggae	african reggae	1
rock cearense	rock cearense	1
liedermacher	liedermacher	1
pittsburgh rock	pittsburgh rock	1
comic	comic	1
modern salsa	modern salsa	1
pinoy praise	pinoy praise	1
sky room	sky room	1
zim urban groove	zim urban groove	1
jovem guarda	jovem guarda	1
deathgrass	deathgrass	1
c-pop	c-pop	1
bedroom soul	bedroom soul	1
alternative rock	alternative rock	1
dansk lovsang	dansk lovsang	1
punk euskera	punk euskera	1
zespol dzieciecy	zespol dzieciecy	1
lo-fi chill	lo-fi chill	1
danish indie pop	danish indie pop	1
brazilian percussion	brazilian percussion	1
dutch prog	dutch prog	1
marathi pop	marathi pop	1
rock of gibraltar	rock of gibraltar	1
italo dance	italo dance	1
smooth jazz	smooth jazz	1
paisley underground	paisley underground	1
sheffield indie	sheffield indie	1
dutch edm	dutch edm	1
african electronic	african electronic	1
scottish indie rock	scottish indie rock	1
post-punk mexicano	post-punk mexicano	1
ska revival	ska revival	1
icelandic electronic	icelandic electronic	1
griot	griot	1
future garage	future garage	1
g funk	g funk	1
israeli singer-songwriter	israeli singer-songwriter	1
swamp rock	swamp rock	1
cork indie	cork indie	1
trap funk	trap funk	1
tampa indie	tampa indie	1
german punk rock	german punk rock	1
czech folk	czech folk	1
southern americana	southern americana	1
peruvian hip hop	peruvian hip hop	1
singaporean indie	singaporean indie	1
diva house	diva house	1
brazilian psychedelic	brazilian psychedelic	1
trance	trance	1
skweee	skweee	1
british blues	british blues	1
greek downtempo	greek downtempo	1
swedish rock-and-roll	swedish rock-and-roll	1
denton tx indie	denton tx indie	1
baluchi folk	baluchi folk	1
taiwan electronic	taiwan electronic	1
desert blues	desert blues	1
miami bass	miami bass	1
rap metal	rap metal	1
drill and bass	drill and bass	1
tejano	tejano	1
australian americana	australian americana	1
rautalanka	rautalanka	1
korean mask singer	korean mask singer	1
neo metal	neo metal	1
danish alternative rock	danish alternative rock	1
chunchaca	chunchaca	1
rhythm game	rhythm game	1
flemish folk	flemish folk	1
mellow gold	mellow gold	1
stomp and holler	stomp and holler	1
orquesta tropical	orquesta tropical	1
e6fi	e6fi	1
pop house	pop house	1
detski pesnichki	detski pesnichki	1
austin singer-songwriter	austin singer-songwriter	1
vogue	vogue	1
pixie	pixie	1
leeds indie	leeds indie	1
norman ok indie	norman ok indie	1
wassoulou	wassoulou	1
anime rock	anime rock	1
czech punk	czech punk	1
rave	rave	1
gothic americana	gothic americana	1
deep downtempo fusion	deep downtempo fusion	1
salsa peruana	salsa peruana	1
hardcore techno	hardcore techno	1
mahraganat	mahraganat	1
australian indie folk	australian indie folk	1
partyschlager	partyschlager	1
norteno-sax	norteno-sax	1
rock alternativo espanol	rock alternativo espanol	1
emo mexicano	emo mexicano	1
beat italiano	beat italiano	1
brazilian emo	brazilian emo	1
argentine indie rock	argentine indie rock	1
oulu indie	oulu indie	1
somali pop	somali pop	1
mande pop	mande pop	1
swiss trap	swiss trap	1
musica popular uruguaya	musica popular uruguaya	1
canadian psychedelic	canadian psychedelic	1
pagode baiano	pagode baiano	1
dutch house	dutch house	1
pirate	pirate	1
deep pop emo	deep pop emo	1
german punk	german punk	1
irish indie	irish indie	1
christian indie	christian indie	1
punk rock mexicano	punk rock mexicano	1
wellington indie	wellington indie	1
deathstep	deathstep	1
swedish folk pop	swedish folk pop	1
drum and bass	drum and bass	1
musica goiana	musica goiana	1
utah indie	utah indie	1
washington indie	washington indie	1
brisbane indie	brisbane indie	1
folk brasileiro	folk brasileiro	1
bristol electronic	bristol electronic	1
anti-folk	anti-folk	1
accordeon	accordeon	1
highlife	highlife	1
canadian celtic	canadian celtic	1
sungura	sungura	1
triangle indie	triangle indie	1
japanese idm	japanese idm	1
aarhus indie	aarhus indie	1
swiss folk	swiss folk	1
chillstep	chillstep	1
heavy gothic rock	heavy gothic rock	1
perreo	perreo	1
alternative americana	alternative americana	1
nasyid	nasyid	1
rock campineiro	rock campineiro	1
hip house	hip house	1
kodomo no ongaku	kodomo no ongaku	1
modern bollywood	modern bollywood	1
idaho indie	idaho indie	1
swansea indie	swansea indie	1
cifteli	cifteli	1
kelowna bc indie	kelowna bc indie	1
jazz boom bap	jazz boom bap	1
macedonian folk	macedonian folk	1
classic moroccan pop	classic moroccan pop	1
tuareg guitar	tuareg guitar	1
rock catarinense	rock catarinense	1
spanish indie rock	spanish indie rock	1
taraneem	taraneem	1
wisconsin indie	wisconsin indie	1
classic rock	classic rock	1
malian blues	malian blues	1
via	via	1
minimal synth	minimal synth	1
folk rock italiano	folk rock italiano	1
boeremusiek	boeremusiek	1
ska jazz	ska jazz	1
brasilia hip hop	brasilia hip hop	1
aghani lil-atfal	aghani lil-atfal	1
roda de samba	roda de samba	1
indie surf	indie surf	1
champeta	champeta	1
tijuana indie	tijuana indie	1
mollywood	mollywood	1
classic garage rock	classic garage rock	1
collage pop	collage pop	1
world fusion	world fusion	1
rumba catalana	rumba catalana	1
trikiti	trikiti	1
jam band	jam band	1
gruperas inmortales	gruperas inmortales	1
happy hardcore	happy hardcore	1
nz singer-songwriter	nz singer-songwriter	1
bornesange	bornesange	1
deep happy hardcore	deep happy hardcore	1
dayton indie	dayton indie	1
alternative ccm	alternative ccm	1
kindermusik	kindermusik	1
post-grunge	post-grunge	1
punk galego	punk galego	1
french punk	french punk	1
ryukyu ongaku	ryukyu ongaku	1
gothic rock	gothic rock	1
hardcore breaks	hardcore breaks	1
duranguense	duranguense	1
taiwan singer-songwriter	taiwan singer-songwriter	1
afrikaans gospel	afrikaans gospel	1
euro hi-nrg	euro hi-nrg	1
detskie pesni	detskie pesni	1
french worship	french worship	1
chicha	chicha	1
indie dream pop	indie dream pop	1
australian children's music	australian children 's music	1
paidika tragoudia	paidika tragoudia	1
cyberpunk	cyberpunk	1
indian singer-songwriter	indian singer-songwriter	1
southern rock	southern rock	1
sambass	sambass	1
electro	electro	1
musica valenciana	musica valenciana	1
socal pop punk	socal pop punk	1
musica menorquina	musica menorquina	1
humppa	humppa	1
traditional ska	traditional ska	1
dutch moombahton	dutch moombahton	1
remix product	remix product	1
fluxwork	fluxwork	1
riot grrrl	riot grrrl	1
nashville singer-songwriter	nashville singer-songwriter	1
spanish invasion	spanish invasion	1
west virginia indie	west virginia indie	1
norwegian americana	norwegian americana	1
soukous	soukous	1
folk siciliana	folk siciliana	1
instrumental funk	instrumental funk	1
musica mogiana	musica mogiana	1
chiptune	chiptune	1
hurdy-gurdy	hurdy-gurdy	1
deconstructed club	deconstructed club	1
rock gotico	rock gotico	1
muziek voor kinderen	muziek voor kinderen	1
experimental electronic	experimental electronic	1
tassie indie	tassie indie	1
cumbia uruguaya	cumbia uruguaya	1
synthwave	synthwave	1
college a cappella	college a cappella	1
new orleans indie	new orleans indie	1
illbient	illbient	1
footwork	footwork	1
iowa indie	iowa indie	1
deep swedish rock	deep swedish rock	1
danish singer-songwriter	danish singer-songwriter	1
nintendocore	nintendocore	1
finnish alternative rock	finnish alternative rock	1
paracana	paracana	1
nightrun	nightrun	1
musique peule	musique peule	1
worship	worship	1
folklore boliviano	folklore boliviano	1
british invasion	british invasion	1
uk worship	uk worship	1
chinese punk	chinese punk	1
punk rock italiano	punk rock italiano	1
deep uplifting trance	deep uplifting trance	1
svensk progg	svensk progg	1
hands up	hands up	1
new orleans funk	new orleans funk	1
italian folk	italian folk	1
folktronica	folktronica	1
darbuka	darbuka	1
modern dream pop	modern dream pop	1
umea indie	umea indie	1
nu skool breaks	nu skool breaks	1
chanson paillarde	chanson paillarde	1
cumbia ecuatoriana	cumbia ecuatoriana	1
salsa choke	salsa choke	1
kurdish folk	kurdish folk	1
german trance	german trance	1
cumbia paraguaya	cumbia paraguaya	1
alternative country	alternative country	1
swamp pop	swamp pop	1
szanty	szanty	1
belfast indie	belfast indie	1
indian electronic	indian electronic	1
west yorkshire indie	west yorkshire indie	1
anthem worship	anthem worship	1
turkish psych	turkish psych	1
samba paulista	samba paulista	1
vaqueiro	vaqueiro	1
punk catala	punk catala	1
british industrial	british industrial	1
rap malien	rap malien	1
aberdeen indie	aberdeen indie	1
modern folk rock	modern folk rock	1
el paso indie	el paso indie	1
rock dominicano	rock dominicano	1
indie viet	indie viet	1
freakbeat	freakbeat	1
classic czech pop	classic czech pop	1
musica canaria	musica canaria	1
deep chill-out	deep chill-out	1
midwest americana	midwest americana	1
trival	trival	1
nu disco	nu disco	1
family gospel	family gospel	1
boston rock	boston rock	1
italian punk	italian punk	1
classic girl group	classic girl group	1
singaporean singer-songwriter	singaporean singer-songwriter	1
modern samba	modern samba	1
nz dnb	nz dnb	1
christian rock	christian rock	1
andean flute	andean flute	1
cowpunk	cowpunk	1
classic opm	classic opm	1
digital hardcore	digital hardcore	1
scottish singer-songwriter	scottish singer-songwriter	1
british alternative rock	british alternative rock	1
lund indie	lund indie	1
classic eurovision	classic eurovision	1
isle of man indie	isle of man indie	1
russian electronic	russian electronic	1
dreamo	dreamo	1
philly indie	philly indie	1
regional mexican	regional mexican	1
italo house	italo house	1
boogie	boogie	1
chanson quebecois	chanson quebecois	1
lldm	lldm	1
spanish indie folk	spanish indie folk	1
new beat	new beat	1
roots rock	roots rock	1
psychedelic folk rock	psychedelic folk rock	1
trondheim indie	trondheim indie	1
merengue	merengue	1
norwegian punk	norwegian punk	1
north carolina indie	north carolina indie	1
banda	banda	1
dark post-punk	dark post-punk	1
novelty	novelty	1
papuri	papuri	1
southern gospel	southern gospel	1
cape verdean folk	cape verdean folk	1
classic finnish pop	classic finnish pop	1
j-pop girl group	j-pop girl group	1
malagasy folk	malagasy folk	1
punk tuga	punk tuga	1
swing revival	swing revival	1
uk americana	uk americana	1
rock alternatif francais	rock alternatif francais	1
supergroup	supergroup	1
disco house	disco house	1
musiikkia lapsille	musiikkia lapsille	1
roots worship	roots worship	1
dutch drill	dutch drill	1
j-pixie	j-pixie	1
aggrotech	aggrotech	1
corrosion	corrosion	1
gwoka	gwoka	1
west african jazz	west african jazz	1
gnawa	gnawa	1
canadian singer-songwriter	canadian singer-songwriter	1
gabba	gabba	1
pop romantico	pop romantico	1
montana roots	montana roots	1
svensk lovsang	svensk lovsang	1
rap dominicano	rap dominicano	1
south african electronic	south african electronic	1
plena uruguaya	plena uruguaya	1
country rock	country rock	1
capoeira	capoeira	1
quebec punk	quebec punk	1
norwegian prog	norwegian prog	1
bury st edmunds indie	bury st edmunds indie	1
chinese post-punk	chinese post-punk	1
ohio indie	ohio indie	1
lo-fi	lo-fi	1
classic persian pop	classic persian pop	1
minimal dubstep	minimal dubstep	1
mbira	mbira	1
protopunk	protopunk	1
tamborazo	tamborazo	1
qawwali	qawwali	1
hardvapour	hardvapour	1
canadian folk	canadian folk	1
preschool children's music	preschool children 's music	1
pop emo	pop emo	1
math pop	math pop	1
jungle	jungle	1
uk reggae	uk reggae	1
japanese melodic punk	japanese melodic punk	1
vapor house	vapor house	1
modern power pop	modern power pop	1
musique alsacienne	musique alsacienne	1
psychedelic blues-rock	psychedelic blues-rock	1
musica indigena brasileira	musica indigena brasileira	1
southern soul	southern soul	1
musica rapa nui	musica rapa nui	1
japanese worship	japanese worship	1
euphoric hardstyle	euphoric hardstyle	1
bristol indie	bristol indie	1
york indie	york indie	1
nubian traditional	nubian traditional	1
timba	timba	1
electronica chilena	electronica chilena	1
gospel	gospel	1
deep norteno	deep norteno	1
rock paraense	rock paraense	1
kayokyoku	kayokyoku	1
cymraeg	cymraeg	1
deep southern soul	deep southern soul	1
german techno	german techno	1
garage rock revival	garage rock revival	1
deep dubstep	deep dubstep	1
delaware indie	delaware indie	1
deep discofox	deep discofox	1
faroese pop	faroese pop	1
classic iskelma	classic iskelma	1
vermont indie	vermont indie	1
tijuana electronic	tijuana electronic	1
folklore paraguayo	folklore paraguayo	1
uk post-punk revival	uk post-punk revival	1
balearic	balearic	1
cinematic dubstep	cinematic dubstep	1
crack rock steady	crack rock steady	1
folclore extremeno	folclore extremeno	1
scottish electronic	scottish electronic	1
glitch beats	glitch beats	1
swiss indie folk	swiss indie folk	1
progressive trance	progressive trance	1
progressive alternative	progressive alternative	1
nyahbinghi	nyahbinghi	1
deep progressive trance	deep progressive trance	1
neo-traditional bluegrass	neo-traditional bluegrass	1
wave	wave	1
russian experimental electronic	russian experimental electronic	1
chamber pop	chamber pop	1
polish prog	polish prog	1
beatdown	beatdown	1
memphis indie	memphis indie	1
spanish punk	spanish punk	1
classic mandopop	classic mandopop	1
spanish prog	spanish prog	1
mambo chileno	mambo chileno	1
cleveland indie	cleveland indie	1
classic italian pop	classic italian pop	1
muzica crestina	muzica crestina	1
tavern	tavern	1
gbvfi	gbvfi	1
garage psych	garage psych	1
uplifting trance	uplifting trance	1
deep german punk	deep german punk	1
spanish post-punk	spanish post-punk	1
mexican classic rock	mexican classic rock	1
alternative pop	alternative pop	1
new orleans americana	new orleans americana	1
kuduro	kuduro	1
alt-idol	alt-idol	1
classic peruvian pop	classic peruvian pop	1
ngoni	ngoni	1
icelandic indie	icelandic indie	1
substep	substep	1
hokkien pop	hokkien pop	1
japanese shoegaze	japanese shoegaze	1
blues rock	blues rock	1
liquid funk	liquid funk	1
classic polish pop	classic polish pop	1
celtic punk	celtic punk	1
children's music	children 's music	1
filmi	filmi	1
indonesian post-hardcore	indonesian post-hardcore	1
lovers rock	lovers rock	1
mpb	mpb	1
rock goiano	rock goiano	1
finnish edm	finnish edm	1
a cappella	a cappella	1
faroese indie	faroese indie	1
indonesian folk	indonesian folk	1
musica sarda	musica sarda	1
funk ostentacao	funk ostentacao	1
fidget house	fidget house	1
lancaster pa indie	lancaster pa indie	1
tucson indie	tucson indie	1
italian electronica	italian electronica	1
garage rock mexicano	garage rock mexicano	1
cantautor catala	cantautor catala	1
new americana	new americana	1
memphis soul	memphis soul	1
nz folk	nz folk	1
indie electronica	indie electronica	1
dunedin indie	dunedin indie	1
chillhop	chillhop	1
boston electronic	boston electronic	1
vintage french electronic	vintage french electronic	1
haryanvi pop	haryanvi pop	1
vaporwave	vaporwave	1
pop punk	pop punk	1
diy emo	diy emo	1
anime cv	anime cv	1
house	house	1
deep psychobilly	deep psychobilly	1
classic venezuelan pop	classic venezuelan pop	1
christian metal	christian metal	1
chinese minyao	chinese minyao	1
punk colombiano	punk colombiano	1
neo-kraut	neo-kraut	1
eastern bloc groove	eastern bloc groove	1
kinderchor	kinderchor	1
canadian rockabilly	canadian rockabilly	1
chilean hardcore	chilean hardcore	1
austin rock	austin rock	1
western saharan folk	western saharan folk	1
spanish folk	spanish folk	1
vietnamese bolero	vietnamese bolero	1
salsa cubana	salsa cubana	1
korean metal	korean metal	1
musique mandingue	musique mandingue	1
gothabilly	gothabilly	1
deep punk rock	deep punk rock	1
musica para criancas	musica para criancas	1
coco	coco	1
classic afrobeat	classic afrobeat	1
future rock	future rock	1
musica crista reformada	musica crista reformada	1
punk urbano	punk urbano	1
medway sound	medway sound	1
cubaton	cubaton	1
bubble trance	bubble trance	1
bubblegum pop	bubblegum pop	1
experimental dubstep	experimental dubstep	1
taiwan experimental	taiwan experimental	1
norteno	norteno	1
tongan pop	tongan pop	1
anarcho-punk	anarcho-punk	1
atmospheric dnb	atmospheric dnb	1
classic soul	classic soul	1
italo beats	italo beats	1
brazilian edm	brazilian edm	1
pinoy pop punk	pinoy pop punk	1
indonesian indie rock	indonesian indie rock	1
old school dancehall	old school dancehall	1
sami	sami	1
sacred steel	sacred steel	1
dainuojamoji poezija	dainuojamoji poezija	1
psychedelic rock	psychedelic rock	1
acid house	acid house	1
pakistani pop	pakistani pop	1
kashmiri pop	kashmiri pop	1
breton folk	breton folk	1
workout product	workout product	1
french dnb	french dnb	1
canadian garage rock	canadian garage rock	1
gothic alternative	gothic alternative	1
folklore nuevo argentino	folklore nuevo argentino	1
black punk	black punk	1
latvian folk	latvian folk	1
classic latvian pop	classic latvian pop	1
garage rock	garage rock	1
gospel italiano	gospel italiano	1
marimba orquesta	marimba orquesta	1
estonian electronic	estonian electronic	1
greek psychedelic rock	greek psychedelic rock	1
gotlandsk musik	gotlandsk musik	1
world worship	world worship	1
irish drill	irish drill	1
sufi	sufi	1
melbourne bounce	melbourne bounce	1
australian singer-songwriter	australian singer-songwriter	1
chutney	chutney	1
chinese metal	chinese metal	1
nueva ola peruana	nueva ola peruana	1
batida	batida	1
vietnamese pop	vietnamese pop	1
classic hardstyle	classic hardstyle	1
musica lombarda	musica lombarda	1
progressive jazz fusion	progressive jazz fusion	1
deep idm	deep idm	1
neo-psychedelic	neo-psychedelic	1
michigan folk	michigan folk	1
chill-out trance	chill-out trance	1
indie singer-songwriter	indie singer-songwriter	1
north dakota indie	north dakota indie	1
polish folk	polish folk	1
classic luk thung	classic luk thung	1
irish experimental electronic	irish experimental electronic	1
western americana	western americana	1
taiwan punk	taiwan punk	1
japanese girl punk	japanese girl punk	1
jump up	jump up	1
intelligent dance music	intelligent dance music	1
gothic doom	gothic doom	1
experimental rock	experimental rock	1
indie anthem-folk	indie anthem-folk	1
cumbia funk	cumbia funk	1
deep orgcore	deep orgcore	1
pakistani folk	pakistani folk	1
power noise	power noise	1
alternative metalcore	alternative metalcore	1
japanese experimental	japanese experimental	1
regional mexican pop	regional mexican pop	1
russian pop punk	russian pop punk	1
women's music	women 's music	1
merseybeat	merseybeat	1
emo punk	emo punk	1
finnish electronic	finnish electronic	1
faroese rock	faroese rock	1
turkish electronic	turkish electronic	1
er ge	er ge	1
idol rock	idol rock	1
folclor colombiano	folclor colombiano	1
swedish singer-songwriter	swedish singer-songwriter	1
brazilian neo-psychedelic	brazilian neo-psychedelic	1
indie folk argentino	indie folk argentino	1
estonian folk	estonian folk	1
deep surf music	deep surf music	1
deathrock	deathrock	1
psychobilly	psychobilly	1
makina	makina	1
gqom	gqom	1
ethio-jazz	ethio-jazz	1
italian gothic	italian gothic	1
new england americana	new england americana	1
duluth indie	duluth indie	1
symphonic rock	symphonic rock	1
slovenian folk	slovenian folk	1
frevo	frevo	1
chill lounge	chill lounge	1
jamgrass	jamgrass	1
emo	emo	1
ringtone	ringtone	1
folk rock	folk rock	1
truck-driving country	truck-driving country	1
canadian post-punk	canadian post-punk	1
vocal house	vocal house	1
abstract idm	abstract idm	1
funky breaks	funky breaks	1
mexican rock-and-roll	mexican rock-and-roll	1
austrian dnb	austrian dnb	1
punk blues	punk blues	1
japanese progressive house	japanese progressive house	1
deep cumbia sonidera	deep cumbia sonidera	1
dutch singer-songwriter	dutch singer-songwriter	1
rock keyboard	rock keyboard	1
destroy techno	destroy techno	1
alternative emo	alternative emo	1
finnish progressive rock	finnish progressive rock	1
ceilidh	ceilidh	1
ruta destroy	ruta destroy	1
nu electro	nu electro	1
scottish americana	scottish americana	1
british math rock	british math rock	1
jumpstyle	jumpstyle	1
vintage swoon	vintage swoon	1
aussie drill	aussie drill	1
cueca chilena	cueca chilena	1
czech electronic	czech electronic	1
cajun	cajun	1
tipico	tipico	1
old school uk hip hop	old school uk hip hop	1
musica portuguesa contemporanea	musica portuguesa contemporanea	1
didgeridoo	didgeridoo	1
russian trance	russian trance	1
deep latin jazz	deep latin jazz	1
future ambient	future ambient	1
neurostep	neurostep	1
deep funk ostentacao	deep funk ostentacao	1
gaita zuliana	gaita zuliana	1
rumba congolaise	rumba congolaise	1
musica folk asturiana	musica folk asturiana	1
steelpan	steelpan	1
musica infantil catala	musica infantil catala	1
ghoststep	ghoststep	1
deep motown	deep motown	1
disney portugues	disney portugues	1
ambient house	ambient house	1
salsa venezolana	salsa venezolana	1
8-bit	8 -bit	1
viking folk	viking folk	1
bossa nova cover	bossa nova cover	1
banda carnavalera	banda carnavalera	1
emocore	emocore	1
tekno	tekno	1
classic praise	classic praise	1
musica afroperuana	musica afroperuana	1
organetto	organetto	1
indie folk	indie folk	1
brazilian punk	brazilian punk	1
messianic praise	messianic praise	1
rumba	rumba	1
eau claire indie	eau claire indie	1
ectofolk	ectofolk	1
disney svenska	disney svenska	1
traditional bluegrass	traditional bluegrass	1
palm desert scene	palm desert scene	1
mantra	mantra	1
brazilian experimental	brazilian experimental	1
chant basque	chant basque	1
dembow	dembow	1
classic korean pop	classic korean pop	1
spoken word	spoken word	1
small room	small room	1
canadian americana	canadian americana	1
swamp blues	swamp blues	1
turkish modern jazz	turkish modern jazz	1
galician folk	galician folk	1
baiao	baiao	1
beach house	beach house	1
outsider house	outsider house	1
musica andorra	musica andorra	1
roots reggae	roots reggae	1
irish singer-songwriter	irish singer-songwriter	1
bossa nova jazz	bossa nova jazz	1
classic arab pop	classic arab pop	1
greek punk	greek punk	1
crossover prog	crossover prog	1
progressive rock	progressive rock	1
spanish electronic	spanish electronic	1
japanese chillhop	japanese chillhop	1
folklore peruano	folklore peruano	1
musica ayacuchana	musica ayacuchana	1
new england emo	new england emo	1
ilocano pop	ilocano pop	1
turkish jazz	turkish jazz	1
nu metal	nu metal	1
breaks	breaks	1
japanese emo	japanese emo	1
banda caliente	banda caliente	1
hard rock	hard rock	1
afro house	afro house	1
ukg revival	ukg revival	1
christian uplift	christian uplift	1
barnemusikk	barnemusikk	1
indonesian bamboo	indonesian bamboo	1
uk dub	uk dub	1
japanese disney	japanese disney	1
indian folk	indian folk	1
basque folk	basque folk	1
dunedin sound	dunedin sound	1
midwest emo	midwest emo	1
jazz colombiano	jazz colombiano	1
japanese post-rock	japanese post-rock	1
uk contemporary jazz	uk contemporary jazz	1
fisarmonica	fisarmonica	1
rock progresivo mexicano	rock progresivo mexicano	1
acid idm	acid idm	1
experimental	experimental	1
deep ragga	deep ragga	1
danish post-punk	danish post-punk	1
huayno	huayno	1
geek folk	geek folk	1
anthem emo	anthem emo	1
russian dnb	russian dnb	1
frenchcore	frenchcore	1
metal guitar	metal guitar	1
chinese jazz	chinese jazz	1
experimental jazz	experimental jazz	1
folclor afrocolombiano	folclor afrocolombiano	1
rawstyle	rawstyle	1
nu gaze	nu gaze	1
speedcore	speedcore	1
marimba de guatemala	marimba de guatemala	1
freak folk	freak folk	1
mpb gospel	mpb gospel	1
spanish metal	spanish metal	1
oberkrainer	oberkrainer	1
turkish edm	turkish edm	1
classic australian country	classic australian country	1
classic psychedelic rock	classic psychedelic rock	1
progressive post-hardcore	progressive post-hardcore	1
mexican pop punk	mexican pop punk	1
bleep techno	bleep techno	1
muzika l'yeladim	muzika l 'yeladim	1
naat	naat	1
reggae	reggae	1
turkish folk	turkish folk	1
musique pour enfant quebecois	musique pour enfant quebecois	1
early reggae	early reggae	1
german show tunes	german show tunes	1
boston folk	boston folk	1
old school hip hop	old school hip hop	1
uk dnb	uk dnb	1
melancholia	melancholia	1
japanese folk	japanese folk	1
balfolk	balfolk	1
neo-progressive	neo-progressive	1
xhosa	xhosa	1
prog quebec	prog quebec	1
braindance	braindance	1
spanish psychedelic rock	spanish psychedelic rock	1
italian progressive rock	italian progressive rock	1
classic pakistani pop	classic pakistani pop	1
korean worship	korean worship	1
uk experimental electronic	uk experimental electronic	1
deep hardcore punk	deep hardcore punk	1
industrial hardcore	industrial hardcore	1
thai metal	thai metal	1
hard bass	hard bass	1
french post-punk	french post-punk	1
french movie tunes	french movie tunes	1
texas pop punk	texas pop punk	1
spacewave	spacewave	1
poezja spiewana	poezja spiewana	1
jazz mexicano	jazz mexicano	1
speed garage	speed garage	1
argentine punk	argentine punk	1
hardstyle	hardstyle	1
musica potosina	musica potosina	1
darksynth	darksynth	1
trap pesado	trap pesado	1
danish punk	danish punk	1
finnish post-punk	finnish post-punk	1
salsa puertorriquena	salsa puertorriquena	1
shred	shred	1
cartoon	cartoon	1
brazilian surf rock	brazilian surf rock	1
bass house	bass house	1
folclore santiagueno	folclore santiagueno	1
german electronica	german electronica	1
australian house	australian house	1
german street punk	german street punk	1
noise pop	noise pop	1
dream pop	dream pop	1
deep breakcore	deep breakcore	1
salsa colombiana	salsa colombiana	1
instrumental rock	instrumental rock	1
umbanda	umbanda	1
glitch	glitch	1
icelandic folk	icelandic folk	1
dub reggae	dub reggae	1
metal salvadoreno	metal salvadoreno	1
deep jazz fusion	deep jazz fusion	1
alternative metal	alternative metal	1
backing track	backing track	1
partido alto	partido alto	1
norwegian gospel	norwegian gospel	1
stomp and flutter	stomp and flutter	1
indonesian emo	indonesian emo	1
hard stoner rock	hard stoner rock	1
swedish americana	swedish americana	1
classic greek pop	classic greek pop	1
cosmic american	cosmic american	1
melodic progressive metal	melodic progressive metal	1
brass band	brass band	1
musica piemonteisa	musica piemonteisa	1
chinderlieder	chinderlieder	1
corridos tumbados	corridos tumbados	1
ghettotech	ghettotech	1
norwegian alternative rock	norwegian alternative rock	1
math rock	math rock	1
huayno popular	huayno popular	1
vallenato moderno	vallenato moderno	1
ranchera	ranchera	1
bakersfield sound	bakersfield sound	1
irish dance	irish dance	1
pinoy traditional	pinoy traditional	1
argentine heavy metal	argentine heavy metal	1
avant-rock	avant-rock	1
neo-trad prog	neo-trad prog	1
melodic hard rock	melodic hard rock	1
australian garage punk	australian garage punk	1
rock steady	rock steady	1
nu-metalcore	nu-metalcore	1
children's folk	children 's folk	1
chinese drama ost	chinese drama ost	1
cumbia lagunera	cumbia lagunera	1
deep chill	deep chill	1
surf music	surf music	1
dusseldorf electronic	dusseldorf electronic	1
barnalog	barnalog	1
gospel soul	gospel soul	1
dutch dnb	dutch dnb	1
sunshine pop	sunshine pop	1
popgaze	popgaze	1
classic turkish pop	classic turkish pop	1
combos nacionales	combos nacionales	1
neo-pagan	neo-pagan	1
irish country	irish country	1
brazilian lo-fi rock	brazilian lo-fi rock	1
deutsch disney	deutsch disney	1
australian post-punk	australian post-punk	1
musica para ninos	musica para ninos	1
ambient idm	ambient idm	1
dub metal	dub metal	1
chicago house	chicago house	1
panpipe	panpipe	1
merengue tipico	merengue tipico	1
old school hard trance	old school hard trance	1
irish rebel song	irish rebel song	1
modern enka	modern enka	1
dub poetry	dub poetry	1
canadian children's music	canadian children 's music	1
austrian stoner rock	austrian stoner rock	1
azeri traditional	azeri traditional	1
hungarian metal	hungarian metal	1
ye ye	ye ye	1
dutch musical	dutch musical	1
cumbia salvadorena	cumbia salvadorena	1
bachata	bachata	1
canadian indie folk	canadian indie folk	1
uyghur folk	uyghur folk	1
brazilian post-hardcore	brazilian post-hardcore	1
chicago soul	chicago soul	1
punk	punk	1
swedish prog	swedish prog	1
north carolina emo	north carolina emo	1
accordion	accordion	1
psychedelic punk	psychedelic punk	1
powwow	powwow	1
vintage chinese pop	vintage chinese pop	1
stateside dnb	stateside dnb	1
sung poetry	sung poetry	1
traditional scottish folk	traditional scottish folk	1
polka	polka	1
tecnobanda	tecnobanda	1
dubsteppe	dubsteppe	1
doomcore	doomcore	1
canzone d'autore	canzone d 'autore	1
instrumental surf	instrumental surf	1
peruvian punk	peruvian punk	1
krautrock	krautrock	1
punk tico	punk tico	1
visual kei	visual kei	1
aussie emo	aussie emo	1
marimba mexicana	marimba mexicana	1
oklahoma country	oklahoma country	1
indie shoegaze	indie shoegaze	1
psybreaks	psybreaks	1
hard glam	hard glam	1
latincore	latincore	1
entehno	entehno	1
spanish progressive rock	spanish progressive rock	1
russian emo	russian emo	1
canadian psychedelic rock	canadian psychedelic rock	1
uwielbienie	uwielbienie	1
musica prehispanica	musica prehispanica	1
chill beats	chill beats	1
slowcore	slowcore	1
folklore chileno	folklore chileno	1
chill groove	chill groove	1
metal catala	metal catala	1
slovenian electronic	slovenian electronic	1
slam poetry	slam poetry	1
ukrainian experimental	ukrainian experimental	1
dream trance	dream trance	1
j-metal	j-metal	1
modern hard rock	modern hard rock	1
medieval folk	medieval folk	1
drumfunk	drumfunk	1
japanese prog	japanese prog	1
indie punk	indie punk	1
psydub	psydub	1
serbian folk	serbian folk	1
charango	charango	1
german oi	german oi	1
hawaiian punk	hawaiian punk	1
psicodelia mexicana	psicodelia mexicana	1
j-punk	j-punk	1
salsa	salsa	1
enka	enka	1
norwegian singer-songwriter	norwegian singer-songwriter	1
huapango	huapango	1
grunge	grunge	1
shamanic	shamanic	1
taiwanese indigenous	taiwanese indigenous	1
folclore castilla y leon	folclore castilla y leon	1
autoharp	autoharp	1
indonesian hardcore	indonesian hardcore	1
song poem	song poem	1
fuji	fuji	1
german hardcore	german hardcore	1
lo-fi house	lo-fi house	1
electric blues	electric blues	1
instrumental math rock	instrumental math rock	1
street punk espanol	street punk espanol	1
nwocr	nwocr	1
louvor	louvor	1
sound collage	sound collage	1
catalan folk	catalan folk	1
tamil worship	tamil worship	1
metal gotico	metal gotico	1
norwegian space disco	norwegian space disco	1
hammond organ	hammond organ	1
vintage rockabilly	vintage rockabilly	1
samba	samba	1
rajasthani folk	rajasthani folk	1
malawian folk	malawian folk	1
dub product	dub product	1
acoustic chill	acoustic chill	1
minimal dnb	minimal dnb	1
progressive bluegrass	progressive bluegrass	1
turkish instrumental	turkish instrumental	1
musique touareg	musique touareg	1
vlaamse cabaret	vlaamse cabaret	1
folclore jujeno	folclore jujeno	1
canterbury scene	canterbury scene	1
deep space rock	deep space rock	1
folk cantabria	folk cantabria	1
hard alternative	hard alternative	1
adventista	adventista	1
finnish punk	finnish punk	1
diy pop punk	diy pop punk	1
chicago pop punk	chicago pop punk	1
indonesian deathcore	indonesian deathcore	1
deep sunset lounge	deep sunset lounge	1
musica timor-leste	musica timor-leste	1
instrumental soul	instrumental soul	1
deep ccm	deep ccm	1
xtra raw	xtra raw	1
acid rock	acid rock	1
italian emo	italian emo	1
african percussion	african percussion	1
acoustic opm	acoustic opm	1
dub	dub	1
swedish punk	swedish punk	1
latin metal	latin metal	1
arizona punk	arizona punk	1
musica popular mineira	musica popular mineira	1
deep groove house	deep groove house	1
jazz tico	jazz tico	1
portuguese folk	portuguese folk	1
korean punk	korean punk	1
texas punk	texas punk	1
nisiotika	nisiotika	1
singer-songwriter	singer-songwriter	1
german hard rock	german hard rock	1
swiss experimental	swiss experimental	1
louvor icm	louvor icm	1
vallenato	vallenato	1
arab electronic	arab electronic	1
japanese vgm	japanese vgm	1
glam metal	glam metal	1
hamburg electronic	hamburg electronic	1
polish psychedelia	polish psychedelia	1
italian metal	italian metal	1
zeuhl	zeuhl	1
classic progressive house	classic progressive house	1
cumbia	cumbia	1
glitter trance	glitter trance	1
dutch experimental electronic	dutch experimental electronic	1
nasheed	nasheed	1
native american	native american	1
musica colombiana instrumental	musica colombiana instrumental	1
sound team	sound team	1
italian pop punk	italian pop punk	1
soul	soul	1
japanese garage rock	japanese garage rock	1
ethereal wave	ethereal wave	1
deep regional mexican	deep regional mexican	1
classic colombian pop	classic colombian pop	1
sotalaulut	sotalaulut	1
israeli punk	israeli punk	1
ukulele	ukulele	1
rhythm and boogie	rhythm and boogie	1
korean ost	korean ost	1
siberian folk	siberian folk	1
manila sound	manila sound	1
vintage dutch pop	vintage dutch pop	1
deep house	deep house	1
rockabilly	rockabilly	1
modern progressive rock	modern progressive rock	1
south asian metal	south asian metal	1
canti alpini	canti alpini	1
korean electronic	korean electronic	1
melodic power metal	melodic power metal	1
australian comedy	australian comedy	1
rock in opposition	rock in opposition	1
irish accordion	irish accordion	1
experimental house	experimental house	1
british experimental	british experimental	1
new wave of glam metal	new wave of glam metal	1
corrido	corrido	1
classic country pop	classic country pop	1
igbo traditional	igbo traditional	1
screamo	screamo	1
deep melodic hard rock	deep melodic hard rock	1
lo-fi beats	lo-fi beats	1
chicago punk	chicago punk	1
folklore panameno	folklore panameno	1
chamame	chamame	1
shoegaze	shoegaze	1
kikuyu pop	kikuyu pop	1
jazz caraibes	jazz caraibes	1
bangla	bangla	1
barnmusik	barnmusik	1
screamocore	screamocore	1
irish electronic	irish electronic	1
australian psych	australian psych	1
mexican power metal	mexican power metal	1
psychill	psychill	1
musica nativista	musica nativista	1
indonesian electronic	indonesian electronic	1
neurofunk	neurofunk	1
trekkspill	trekkspill	1
rock-and-roll	rock-and-roll	1
post-hardcore	post-hardcore	1
deep liquid bass	deep liquid bass	1
deep neofolk	deep neofolk	1
swancore	swancore	1
shamisen	shamisen	1
deep dnb	deep dnb	1
croatian folk	croatian folk	1
christian hard rock	christian hard rock	1
thrash-groove metal	thrash-groove metal	1
salsa international	salsa international	1
german dnb	german dnb	1
sleaze rock	sleaze rock	1
early us punk	early us punk	1
brazilian house	brazilian house	1
circus	circus	1
shanty	shanty	1
deep liquid	deep liquid	1
kannada bhava geethe	kannada bhava geethe	1
mexican son	mexican son	1
gaita	gaita	1
progressive power metal	progressive power metal	1
russian shoegaze	russian shoegaze	1
modern old-time	modern old-time	1
deep power-pop punk	deep power-pop punk	1
flamenco	flamenco	1
bouzouki	bouzouki	1
sheilat	sheilat	1
prog metal	prog metal	1
italian trance	italian trance	1
italian post-hardcore	italian post-hardcore	1
tamburica	tamburica	1
surf punk	surf punk	1
outsider	outsider	1
spanish stoner rock	spanish stoner rock	1
dutch disney	dutch disney	1
jazz rock	jazz rock	1
traditional rockabilly	traditional rockabilly	1
metal ecuatoriano	metal ecuatoriano	1
uk house	uk house	1
psychedelic folk	psychedelic folk	1
folk	folk	1
finnish jazz	finnish jazz	1
neofolk	neofolk	1
shabad	shabad	1
dark hardcore	dark hardcore	1
porro	porro	1
uptempo hardcore	uptempo hardcore	1
microhouse	microhouse	1
outlaw country	outlaw country	1
dutch punk	dutch punk	1
croatian metal	croatian metal	1
latin surf rock	latin surf rock	1
japanese punk rock	japanese punk rock	1
klapa	klapa	1
hard trance	hard trance	1
uk beatdown	uk beatdown	1
dweilorkest	dweilorkest	1
brill building pop	brill building pop	1
indian jazz	indian jazz	1
brazilian stoner rock	brazilian stoner rock	1
french metal	french metal	1
terrorcore	terrorcore	1
neo-trad doom metal	neo-trad doom metal	1
euskal metal	euskal metal	1
russian metal	russian metal	1
progressive uplifting trance	progressive uplifting trance	1
musica de intervencao	musica de intervencao	1
argentine hardcore	argentine hardcore	1
malaysian metal	malaysian metal	1
jazz venezolano	jazz venezolano	1
south african metal	south african metal	1
math rock latinoamericano	math rock latinoamericano	1
polish noise rock	polish noise rock	1
slash punk	slash punk	1
indie psychedelic rock	indie psychedelic rock	1
jazz funk	jazz funk	1
acid trance	acid trance	1
japanese electronic	japanese electronic	1
metal uruguayo	metal uruguayo	1
italian library music	italian library music	1
chinese worship	chinese worship	1
gothic symphonic metal	gothic symphonic metal	1
float house	float house	1
space rock	space rock	1
murga	murga	1
neo classical metal	neo classical metal	1
sinogaze	sinogaze	1
swedish progressive metal	swedish progressive metal	1
swedish garage rock	swedish garage rock	1
estonian metal	estonian metal	1
chinese post-rock	chinese post-rock	1
musica jibara	musica jibara	1
dark psytrance	dark psytrance	1
new jersey punk	new jersey punk	1
finnish folk	finnish folk	1
juju	juju	1
christmas product	christmas product	1
guaracha	guaracha	1
horror punk	horror punk	1
coverchill	coverchill	1
darkstep	darkstep	1
uk pop punk	uk pop punk	1
chanson	chanson	1
football	football	1
skiffle	skiffle	1
tribal house	tribal house	1
skramz	skramz	1
finnish hard rock	finnish hard rock	1
celtic	celtic	1
german metal	german metal	1
punjabi folk	punjabi folk	1
swedish indie folk	swedish indie folk	1
fast melodic punk	fast melodic punk	1
deep brazilian pop	deep brazilian pop	1
cologne electronic	cologne electronic	1
bolivian metal	bolivian metal	1
heavy alternative	heavy alternative	1
cuatro venezolano	cuatro venezolano	1
experimental techno	experimental techno	1
polish experimental electronic	polish experimental electronic	1
electronic djent	electronic djent	1
anime score	anime score	1
japanese psychedelic	japanese psychedelic	1
progressive trance house	progressive trance house	1
nueva trova chilena	nueva trova chilena	1
classic nepali pop	classic nepali pop	1
instrumental bluegrass	instrumental bluegrass	1
doo-wop	doo-wop	1
ambient techno	ambient techno	1
spytrack	spytrack	1
soda pop	soda pop	1
indie game soundtrack	indie game soundtrack	1
funk bh	funk bh	1
steel guitar	steel guitar	1
goa trance	goa trance	1
peruvian experimental	peruvian experimental	1
bush ballad	bush ballad	1
fallen angel	fallen angel	1
rune folk	rune folk	1
ambient trance	ambient trance	1
italian jazz fusion	italian jazz fusion	1
african experimental	african experimental	1
garage pop	garage pop	1
puerto rican folk	puerto rican folk	1
norwegian psychedelic	norwegian psychedelic	1
kosovan folk	kosovan folk	1
british singer-songwriter	british singer-songwriter	1
somatik techno	somatik techno	1
belarusian electronic	belarusian electronic	1
trova	trova	1
vancouver punk	vancouver punk	1
bluegrass gospel	bluegrass gospel	1
mexican experimental	mexican experimental	1
martial industrial	martial industrial	1
uk diy punk	uk diy punk	1
dc hardcore	dc hardcore	1
noise rock	noise rock	1
italian industrial	italian industrial	1
deep metalcore	deep metalcore	1
finnish modern jazz	finnish modern jazz	1
viola caipira	viola caipira	1
trash rock	trash rock	1
latino comedy	latino comedy	1
folklore quebecois	folklore quebecois	1
slovak electronic	slovak electronic	1
circuit	circuit	1
dutch punk rock	dutch punk rock	1
bulgarian metal	bulgarian metal	1
swedish psychedelic rock	swedish psychedelic rock	1
slovak folk	slovak folk	1
christian thrash metal	christian thrash metal	1
skate punk	skate punk	1
experimental vocal	experimental vocal	1
brega funk	brega funk	1
swedish house	swedish house	1
belgian post-rock	belgian post-rock	1
hard dance	hard dance	1
indonesian shoegaze	indonesian shoegaze	1
boogaloo	boogaloo	1
musica llanera	musica llanera	1
uk post-hardcore	uk post-hardcore	1
korean experimental	korean experimental	1
african metal	african metal	1
lithuanian electronic	lithuanian electronic	1
pinoy metal	pinoy metal	1
pop folk	pop folk	1
ilahiler	ilahiler	1
progressive metal	progressive metal	1
dreamgaze	dreamgaze	1
australian hardcore	australian hardcore	1
chicano punk	chicano punk	1
retro metal	retro metal	1
belgian punk	belgian punk	1
metal catarinense	metal catarinense	1
belgian modern jazz	belgian modern jazz	1
nueva ola chilena	nueva ola chilena	1
nursery	nursery	1
argentine metal	argentine metal	1
vancouver metal	vancouver metal	1
cape breton folk	cape breton folk	1
jazz metal	jazz metal	1
japanese pop punk	japanese pop punk	1
indie triste	indie triste	1
mexican traditional	mexican traditional	1
italian progressive metal	italian progressive metal	1
spanish folk metal	spanish folk metal	1
russian power metal	russian power metal	1
deep melodic metalcore	deep melodic metalcore	1
german shoegaze	german shoegaze	1
folk metal latinoamericano	folk metal latinoamericano	1
folclore salteno	folclore salteno	1
charanga	charanga	1
swedish hard rock	swedish hard rock	1
deep psytrance	deep psytrance	1
bolero	bolero	1
scottish indie folk	scottish indie folk	1
deep full on	deep full on	1
proto-rap	proto-rap	1
rhythm and blues	rhythm and blues	1
caribbean metal	caribbean metal	1
brazilian punk rock	brazilian punk rock	1
suomisaundi	suomisaundi	1
draaiorgel	draaiorgel	1
balkan folk metal	balkan folk metal	1
german post-rock	german post-rock	1
halloween	halloween	1
moroccan traditional	moroccan traditional	1
tibetan mantra	tibetan mantra	1
czech metal	czech metal	1
nueva cancion	nueva cancion	1
metal tico	metal tico	1
h8000	h8000	1
power-pop punk	power-pop punk	1
peruvian metal	peruvian metal	1
skinhead oi	skinhead oi	1
indonesian experimental	indonesian experimental	1
arpa paraguaya	arpa paraguaya	1
slayer	slayer	1
louisiana blues	louisiana blues	1
samba de roda	samba de roda	1
psych gaze	psych gaze	1
south african choral	south african choral	1
velha guarda	velha guarda	1
italian folk metal	italian folk metal	1
lounge house	lounge house	1
techno	techno	1
trance brasileiro	trance brasileiro	1
bluegrass	bluegrass	1
tabla	tabla	1
electric bass	electric bass	1
judaica	judaica	1
beats	beats	1
bard	bard	1
dragspel	dragspel	1
dutch cabaret	dutch cabaret	1
senegalese traditional	senegalese traditional	1
soul blues	soul blues	1
new jersey hardcore	new jersey hardcore	1
metal balear	metal balear	1
french shoegaze	french shoegaze	1
nz punk	nz punk	1
gothic metal	gothic metal	1
irish pub song	irish pub song	1
miami metal	miami metal	1
mexican post-rock	mexican post-rock	1
glam punk	glam punk	1
musique soninke	musique soninke	1
christelijk	christelijk	1
barbershop	barbershop	1
korean jazz	korean jazz	1
brazilian progressive metal	brazilian progressive metal	1
post-screamo	post-screamo	1
punk mexicano	punk mexicano	1
mandolin	mandolin	1
greek clarinet	greek clarinet	1
oi	oi	1
central american metal	central american metal	1
hard house	hard house	1
swedish heavy metal	swedish heavy metal	1
folklore venezolano	folklore venezolano	1
avant-garde metal	avant-garde metal	1
organic ambient	organic ambient	1
orgcore	orgcore	1
gymcore	gymcore	1
abstract	abstract	1
german house	german house	1
norwegian punk rock	norwegian punk rock	1
vegan straight edge	vegan straight edge	1
sunset lounge	sunset lounge	1
canadian pop punk	canadian pop punk	1
greek folk	greek folk	1
welsh metal	welsh metal	1
albanian folk	albanian folk	1
classic nz country	classic nz country	1
polish hardcore	polish hardcore	1
ambient psychill	ambient psychill	1
deep folk metal	deep folk metal	1
classic tunisian pop	classic tunisian pop	1
banjo	banjo	1
ambient pop	ambient pop	1
russian folk metal	russian folk metal	1
candomble	candomble	1
detroit techno	detroit techno	1
latvian metal	latvian metal	1
scottish folk	scottish folk	1
jazz accordion	jazz accordion	1
greek metal	greek metal	1
oriental metal	oriental metal	1
greek guitar	greek guitar	1
groove room	groove room	1
inuit traditional	inuit traditional	1
new orleans blues	new orleans blues	1
trancecore	trancecore	1
rock noise	rock noise	1
canadian punk	canadian punk	1
modern psychedelic folk	modern psychedelic folk	1
portuguese jazz	portuguese jazz	1
connecticut hardcore	connecticut hardcore	1
ukrainian electronic	ukrainian electronic	1
easycore	easycore	1
finnish experimental	finnish experimental	1
irish neo-traditional	irish neo-traditional	1
harmonica blues	harmonica blues	1
hawaiian	hawaiian	1
munich electronic	munich electronic	1
native american spiritual	native american spiritual	1
hardcore	hardcore	1
turkish soundtrack	turkish soundtrack	1
appenzeller folk	appenzeller folk	1
danish modern jazz	danish modern jazz	1
detske pisnicky	detske pisnicky	1
russian hardcore	russian hardcore	1
focus beats	focus beats	1
portuguese metal	portuguese metal	1
hauntology	hauntology	1
latin house	latin house	1
swing italiano	swing italiano	1
starogradska	starogradska	1
southeast asian post-rock	southeast asian post-rock	1
slovak metal	slovak metal	1
neoclassical darkwave	neoclassical darkwave	1
latin jazz	latin jazz	1
norwegian doom metal	norwegian doom metal	1
chinese audiophile	chinese audiophile	1
new weird finland	new weird finland	1
pornogrind	pornogrind	1
canto popular uruguayo	canto popular uruguayo	1
minneapolis punk	minneapolis punk	1
brazilian power metal	brazilian power metal	1
instrumental stoner rock	instrumental stoner rock	1
taiwan campus folk	taiwan campus folk	1
japanese jazz	japanese jazz	1
japanese psychedelic rock	japanese psychedelic rock	1
electronicore	electronicore	1
finnish psychedelic rock	finnish psychedelic rock	1
ghazal	ghazal	1
klezmer	klezmer	1
detroit house	detroit house	1
drone psych	drone psych	1
opera metal	opera metal	1
bossa nova	bossa nova	1
stoner rock	stoner rock	1
folklore argentino	folklore argentino	1
celtic metal	celtic metal	1
japanese vocal jazz	japanese vocal jazz	1
noise punk	noise punk	1
cornish folk	cornish folk	1
austrian metal	austrian metal	1
dub techno	dub techno	1
alphorn	alphorn	1
arabic jazz	arabic jazz	1
mariachi	mariachi	1
swiss metal	swiss metal	1
british folk	british folk	1
irish folk	irish folk	1
polish folk metal	polish folk metal	1
southern metal	southern metal	1
stoner metal	stoner metal	1
organic electronic	organic electronic	1
cocuk sarkilari	cocuk sarkilari	1
cancion melodica	cancion melodica	1
dutch folk	dutch folk	1
romantico	romantico	1
tanzanian traditional	tanzanian traditional	1
afro-cuban traditional	afro-cuban traditional	1
raw black metal	raw black metal	1
danish experimental	danish experimental	1
canadian metal	canadian metal	1
new tribe	new tribe	1
indonesian metal	indonesian metal	1
piada	piada	1
brazilian hardcore	brazilian hardcore	1
neo kyma	neo kyma	1
mexican metal	mexican metal	1
alabama metal	alabama metal	1
slavic folk metal	slavic folk metal	1
algerian folk	algerian folk	1
icelandic experimental	icelandic experimental	1
luxembourgian metal	luxembourgian metal	1
italian power metal	italian power metal	1
pasodobles	pasodobles	1
norwegian experimental	norwegian experimental	1
chilean metal	chilean metal	1
uk noise rock	uk noise rock	1
scottish metal	scottish metal	1
funeral doom	funeral doom	1
kora	kora	1
straight edge	straight edge	1
jazz chileno	jazz chileno	1
yoik	yoik	1
post-rock latinoamericano	post-rock latinoamericano	1
language	language	1
belgian hardcore	belgian hardcore	1
power metal	power metal	1
italogaze	italogaze	1
egyptian traditional	egyptian traditional	1
german stoner rock	german stoner rock	1
progressive groove metal	progressive groove metal	1
folklore veracruzano	folklore veracruzano	1
new weird america	new weird america	1
danish techno	danish techno	1
malian traditional	malian traditional	1
gypsy	gypsy	1
rave funk	rave funk	1
new isolationism	new isolationism	1
final fantasy	final fantasy	1
colombian hardcore	colombian hardcore	1
nashville sound	nashville sound	1
horror punk brasileiro	horror punk brasileiro	1
rebetiko	rebetiko	1
balafon	balafon	1
guatemalan metal	guatemalan metal	1
library music	library music	1
trio huasteco	trio huasteco	1
modular synth	modular synth	1
spanish post-rock	spanish post-rock	1
norwegian hardcore	norwegian hardcore	1
joropo	joropo	1
japanese heavy metal	japanese heavy metal	1
swedish emo	swedish emo	1
deep soul house	deep soul house	1
indian metal	indian metal	1
canzone napoletana	canzone napoletana	1
orquesta cubana	orquesta cubana	1
arkansas country	arkansas country	1
christian power metal	christian power metal	1
canadian shoegaze	canadian shoegaze	1
metalcore espanol	metalcore espanol	1
turkish experimental	turkish experimental	1
american shoegaze	american shoegaze	1
nordic folk	nordic folk	1
children's choir	children 's choir	1
progressive thrash	progressive thrash	1
symphonic metal	symphonic metal	1
throat singing	throat singing	1
brazilian modern jazz	brazilian modern jazz	1
portuguese experimental	portuguese experimental	1
british jazz	british jazz	1
forest psy	forest psy	1
swedish post-hardcore	swedish post-hardcore	1
histoire pour enfants	histoire pour enfants	1
classic japanese jazz	classic japanese jazz	1
power thrash	power thrash	1
japanese post-hardcore	japanese post-hardcore	1
hardcore punk espanol	hardcore punk espanol	1
swedish power metal	swedish power metal	1
garage punk	garage punk	1
israeli folk	israeli folk	1
irish modern jazz	irish modern jazz	1
kawaii metal	kawaii metal	1
folk metal	folk metal	1
nwothm	nwothm	1
old west	old west	1
irish banjo	irish banjo	1
uk metalcore	uk metalcore	1
mambo	mambo	1
street punk	street punk	1
folklore uruguayo	folklore uruguayo	1
kirtan	kirtan	1
dutch jazz	dutch jazz	1
horror synth	horror synth	1
christian hardcore	christian hardcore	1
contemporary folk	contemporary folk	1
swedish stoner rock	swedish stoner rock	1
neo-trad metal	neo-trad metal	1
corsican folk	corsican folk	1
metal	metal	1
deep active rock	deep active rock	1
turkish black metal	turkish black metal	1
djent	djent	1
chaabi algerien	chaabi algerien	1
christian a cappella	christian a cappella	1
faroese jazz	faroese jazz	1
kundiman	kundiman	1
sefardi	sefardi	1
cosmic uplifting trance	cosmic uplifting trance	1
polish jazz	polish jazz	1
ambient industrial	ambient industrial	1
atmospheric sludge	atmospheric sludge	1
russian romance	russian romance	1
montana metal	montana metal	1
gospel singers	gospel singers	1
contemporary vocal jazz	contemporary vocal jazz	1
polish experimental	polish experimental	1
melodic hardcore	melodic hardcore	1
nyhc	nyhc	1
scottish gaelic folk	scottish gaelic folk	1
finnish power metal	finnish power metal	1
irish techno	irish techno	1
dark disco	dark disco	1
experimental big band	experimental big band	1
italian gothic metal	italian gothic metal	1
old-time fiddle	old-time fiddle	1
japanese techno	japanese techno	1
burundian traditional	burundian traditional	1
christian relaxative	christian relaxative	1
australian thrash metal	australian thrash metal	1
jumptek	jumptek	1
cyber metal	cyber metal	1
experimental percussion	experimental percussion	1
mexican hardcore	mexican hardcore	1
ukhc	ukhc	1
full on	full on	1
bal-musette	bal-musette	1
technical groove metal	technical groove metal	1
hollywood	hollywood	1
bulgarian experimental	bulgarian experimental	1
finnish techno	finnish techno	1
ambient dub techno	ambient dub techno	1
jazz organ	jazz organ	1
sufi chant	sufi chant	1
spanish experimental	spanish experimental	1
calypso	calypso	1
mento	mento	1
post-post-hardcore	post-post-hardcore	1
experimental synth	experimental synth	1
jazz cubano	jazz cubano	1
schranz	schranz	1
belgian stoner rock	belgian stoner rock	1
finnish metal	finnish metal	1
kentucky metal	kentucky metal	1
pop violin	pop violin	1
finnish tango	finnish tango	1
canzone genovese	canzone genovese	1
swedish doom metal	swedish doom metal	1
viking metal	viking metal	1
virginia punk	virginia punk	1
french post-rock	french post-rock	1
brazilian metal	brazilian metal	1
bagpipe marching band	bagpipe marching band	1
chicago blues	chicago blues	1
erotica	erotica	1
sitar	sitar	1
guggenmusik	guggenmusik	1
chicago hardcore	chicago hardcore	1
modern big band	modern big band	1
galician jazz	galician jazz	1
swedish electronic	swedish electronic	1
punk 'n' roll	punk 'n ' roll	1
psychedelic doom	psychedelic doom	1
canadian house	canadian house	1
korean hardcore	korean hardcore	1
belgian singer-songwriter	belgian singer-songwriter	1
puerto rican metal	puerto rican metal	1
tech house	tech house	1
kritika	kritika	1
austrian jazz	austrian jazz	1
disney italiano	disney italiano	1
greek house	greek house	1
zampogna	zampogna	1
sarangi	sarangi	1
show tunes	show tunes	1
string band	string band	1
nwobhm	nwobhm	1
middle earth	middle earth	1
yorkshire folk	yorkshire folk	1
dutch metal	dutch metal	1
uk82	uk82	1
zikir	zikir	1
nohay	nohay	1
cha-cha-cha	cha-cha-cha	1
slavic metal	slavic metal	1
boston punk	boston punk	1
north carolina metal	north carolina metal	1
carnatic instrumental	carnatic instrumental	1
canadian post-rock	canadian post-rock	1
atmospheric post-metal	atmospheric post-metal	1
latin shoegaze	latin shoegaze	1
faroese folk	faroese folk	1
deep darkpsy	deep darkpsy	1
nova canco	nova canco	1
metal galego	metal galego	1
gothenburg metal	gothenburg metal	1
theremin	theremin	1
colombian electronic	colombian electronic	1
metal paranaense	metal paranaense	1
norwegian techno	norwegian techno	1
danish folk	danish folk	1
hardcore punk	hardcore punk	1
serbian metal	serbian metal	1
polish metal	polish metal	1
romanian folk	romanian folk	1
cuban rumba	cuban rumba	1
traditional folk	traditional folk	1
tennessee metal	tennessee metal	1
welsh folk	welsh folk	1
american post-rock	american post-rock	1
metallic hardcore	metallic hardcore	1
veena	veena	1
grim death metal	grim death metal	1
hammered dulcimer	hammered dulcimer	1
groove metal	groove metal	1
christian symphonic metal	christian symphonic metal	1
swedish jazz	swedish jazz	1
clawhammer banjo	clawhammer banjo	1
belgian experimental	belgian experimental	1
thai instrumental	thai instrumental	1
japanoise	japanoise	1
uk stoner rock	uk stoner rock	1
scottish smallpipe	scottish smallpipe	1
psychedelic trance	psychedelic trance	1
slovenian metal	slovenian metal	1
moog	moog	1
school choir	school choir	1
cybergrind	cybergrind	1
honky-tonk piano	honky-tonk piano	1
belarusian metal	belarusian metal	1
piseiro	piseiro	1
folkmusik	folkmusik	1
thall	thall	1
finnish hardcore	finnish hardcore	1
hi-tech	hi-tech	1
blues	blues	1
estonian jazz	estonian jazz	1
burkinabe traditional	burkinabe traditional	1
cleveland metal	cleveland metal	1
leipzig electronic	leipzig electronic	1
italian modern prog	italian modern prog	1
american metalcore	american metalcore	1
brazilian metalcore	brazilian metalcore	1
progressive breaks	progressive breaks	1
melodic metal	melodic metal	1
tech trance	tech trance	1
yunnan traditional	yunnan traditional	1
son cubano	son cubano	1
japanese metalcore	japanese metalcore	1
theme	theme	1
icelandic jazz	icelandic jazz	1
frankfurt electronic	frankfurt electronic	1
epicore	epicore	1
speed metal	speed metal	1
italian experimental	italian experimental	1
folclore tucumano	folclore tucumano	1
australian metal	australian metal	1
romanian metal	romanian metal	1
indonesian death metal	indonesian death metal	1
school ensemble	school ensemble	1
unblack metal	unblack metal	1
disney	disney	1
israeli metal	israeli metal	1
japanese power metal	japanese power metal	1
british post-rock	british post-rock	1
tagalog worship	tagalog worship	1
polish post-rock	polish post-rock	1
jazz fusion	jazz fusion	1
instrumental progressive metal	instrumental progressive metal	1
power electronics	power electronics	1
cello	cello	1
greek jazz	greek jazz	1
brazilian post-rock	brazilian post-rock	1
cowboy western	cowboy western	1
flamenco guitar	flamenco guitar	1
new england experimental	new england experimental	1
country gospel	country gospel	1
minimal melodic techno	minimal melodic techno	1
vintage swedish pop	vintage swedish pop	1
metal paraguayo	metal paraguayo	1
choro	choro	1
swiss jazz	swiss jazz	1
mandible	mandible	1
min'yo	min 'yo	1
irish metal	irish metal	1
ballroom	ballroom	1
bow pop	bow pop	1
minimal techno	minimal techno	1
action rock	action rock	1
indian violin	indian violin	1
christian metalcore	christian metalcore	1
birmingham metal	birmingham metal	1
west virginia metal	west virginia metal	1
acid techno	acid techno	1
mongolian folk	mongolian folk	1
australian experimental	australian experimental	1
metalcore	metalcore	1
folklore ecuatoriano	folklore ecuatoriano	1
metal colombiano	metal colombiano	1
danish jazz	danish jazz	1
traditional british folk	traditional british folk	1
symphonic power metal	symphonic power metal	1
jazz catala	jazz catala	1
tatar folk	tatar folk	1
harmonikka	harmonikka	1
melodic thrash	melodic thrash	1
funky tech house	funky tech house	1
industrial techno	industrial techno	1
prepared piano	prepared piano	1
brazilian heavy metal	brazilian heavy metal	1
boston hardcore	boston hardcore	1
berlin school	berlin school	1
experimental folk	experimental folk	1
texas blues	texas blues	1
himalayan folk	himalayan folk	1
russian jazz	russian jazz	1
progressive doom	progressive doom	1
post-rock	post-rock	1
tolkien metal	tolkien metal	1
scottish fiddle	scottish fiddle	1
icelandic metal	icelandic metal	1
old school thrash	old school thrash	1
orkney and shetland folk	orkney and shetland folk	1
melodic deathcore	melodic deathcore	1
brazilian thrash metal	brazilian thrash metal	1
brazilian jazz	brazilian jazz	1
memphis blues	memphis blues	1
macedonian electronic	macedonian electronic	1
irish experimental	irish experimental	1
west end	west end	1
thrash core	thrash core	1
space age pop	space age pop	1
thrash metal	thrash metal	1
french folk	french folk	1
comedy rock	comedy rock	1
scottish techno	scottish techno	1
polynesian traditional	polynesian traditional	1
french techno	french techno	1
german pagan metal	german pagan metal	1
venezuelan metal	venezuelan metal	1
swedish techno	swedish techno	1
german metalcore	german metalcore	1
canadian post-hardcore	canadian post-hardcore	1
band organ	band organ	1
trio cubano	trio cubano	1
nz hardcore	nz hardcore	1
atmospheric post-rock	atmospheric post-rock	1
muzica populara	muzica populara	1
ukrainian metal	ukrainian metal	1
classic bollywood	classic bollywood	1
crust punk	crust punk	1
kabarett	kabarett	1
musica andina	musica andina	1
musicas espiritas	musicas espiritas	1
powerviolence	powerviolence	1
bagpipe	bagpipe	1
heavy psych	heavy psych	1
russian post-rock	russian post-rock	1
wisconsin metal	wisconsin metal	1
italian occult psychedelia	italian occult psychedelia	1
belgian metal	belgian metal	1
pilates	pilates	1
german post-hardcore	german post-hardcore	1
italian metalcore	italian metalcore	1
caucasian folk	caucasian folk	1
ambient folk	ambient folk	1
fo jing	fo jing	1
jig and reel	jig and reel	1
polish techno	polish techno	1
australian shoegaze	australian shoegaze	1
piano blues	piano blues	1
technical thrash	technical thrash	1
taiwan metal	taiwan metal	1
portuguese death metal	portuguese death metal	1
chinese instrumental	chinese instrumental	1
mexican techno	mexican techno	1
portuguese post-rock	portuguese post-rock	1
melodic metalcore	melodic metalcore	1
indonesian black metal	indonesian black metal	1
deep disco house	deep disco house	1
bosnian electronic	bosnian electronic	1
sci-fi metal	sci-fi metal	1
harmonica jazz	harmonica jazz	1
colorado hardcore	colorado hardcore	1
amapiano	amapiano	1
arab metal	arab metal	1
spiritual jazz	spiritual jazz	1
rwandan traditional	rwandan traditional	1
modular techno	modular techno	1
deep hardtechno	deep hardtechno	1
noise	noise	1
gamelan	gamelan	1
deep free jazz	deep free jazz	1
australian post-rock	australian post-rock	1
ambient worship	ambient worship	1
belfast metal	belfast metal	1
swedish metal	swedish metal	1
landler	landler	1
audiophile vocal	audiophile vocal	1
dombra	dombra	1
country boogie	country boogie	1
traditional english folk	traditional english folk	1
italian stoner rock	italian stoner rock	1
polish thrash metal	polish thrash metal	1
mallet	mallet	1
son cubano clasico	son cubano clasico	1
kleine hoerspiel	kleine hoerspiel	1
swedish metalcore	swedish metalcore	1
necrogrind	necrogrind	1
experimental psych	experimental psych	1
jazz drums	jazz drums	1
cimbalom	cimbalom	1
broadway	broadway	1
cuento infantile	cuento infantile	1
danish metal	danish metal	1
jump blues	jump blues	1
gaian doom	gaian doom	1
jazz tuba	jazz tuba	1
haitian traditional	haitian traditional	1
canadian experimental	canadian experimental	1
italian mandolin	italian mandolin	1
brutal deathcore	brutal deathcore	1
singaporean metal	singaporean metal	1
washboard	washboard	1
progressive metalcore	progressive metalcore	1
korean phantom singer	korean phantom singer	1
fado	fado	1
dutch tech house	dutch tech house	1
honky tonk	honky tonk	1
indian classical	indian classical	1
minneapolis metal	minneapolis metal	1
j-ambient	j-ambient	1
virginia metal	virginia metal	1
mexican thrash metal	mexican thrash metal	1
uk doom metal	uk doom metal	1
northumbrian folk	northumbrian folk	1
doom metal	doom metal	1
papuan traditional	papuan traditional	1
jazz orchestra	jazz orchestra	1
exotica	exotica	1
jazz composition	jazz composition	1
space ambient	space ambient	1
western ny metal	western ny metal	1
berlin minimal techno	berlin minimal techno	1
latin american heavy psych	latin american heavy psych	1
lithuanian metal	lithuanian metal	1
djembe	djembe	1
adult standards	adult standards	1
liechtenstein	liechtenstein	1
swiss black metal	swiss black metal	1
blaskapelle	blaskapelle	1
swedish pop punk	swedish pop punk	1
pennsylvania hardcore	pennsylvania hardcore	1
epic doom	epic doom	1
bolero cubano	bolero cubano	1
boston metal	boston metal	1
sundanese traditional	sundanese traditional	1
deep euro house	deep euro house	1
hindustani classical	hindustani classical	1
nz metal	nz metal	1
texas hardcore	texas hardcore	1
melodic doom	melodic doom	1
polish ambient	polish ambient	1
vintage western	vintage western	1
musique pour enfants	musique pour enfants	1
duduk	duduk	1
lds	lds	1
chamber folk	chamber folk	1
scottish jazz	scottish jazz	1
japanese hardcore	japanese hardcore	1
spanish death metal	spanish death metal	1
jazz violin	jazz violin	1
melodic groove metal	melodic groove metal	1
romanian electronic	romanian electronic	1
avant-garde black metal	avant-garde black metal	1
experimental guitar	experimental guitar	1
pittsburgh metal	pittsburgh metal	1
tibetan traditional	tibetan traditional	1
jazz flute	jazz flute	1
jazz vibraphone	jazz vibraphone	1
edinburgh metal	edinburgh metal	1
atmospheric doom	atmospheric doom	1
experimental black metal	experimental black metal	1
mluvene slovo	mluvene slovo	1
industrial black metal	industrial black metal	1
carnatic	carnatic	1
japanese soundtrack	japanese soundtrack	1
deathcore	deathcore	1
metal baiano	metal baiano	1
german death metal	german death metal	1
italian hardcore	italian hardcore	1
canadian modern jazz	canadian modern jazz	1
old-time	old-time	1
croatian electronic	croatian electronic	1
deep melodic death metal	deep melodic death metal	1
minimal dub	minimal dub	1
australian metalcore	australian metalcore	1
italian doom metal	italian doom metal	1
german thrash metal	german thrash metal	1
sludge metal	sludge metal	1
concertina	concertina	1
australian post-hardcore	australian post-hardcore	1
norwegian contemporary jazz	norwegian contemporary jazz	1
ethnomusicology	ethnomusicology	1
kenyan traditional	kenyan traditional	1
music box	music box	1
oulu metal	oulu metal	1
black comedy	black comedy	1
modern swing	modern swing	1
violao	violao	1
dark ambient	dark ambient	1
new wave of speed metal	new wave of speed metal	1
german jazz	german jazz	1
buffalo ny metal	buffalo ny metal	1
hindustani instrumental	hindustani instrumental	1
coptic hymn	coptic hymn	1
lovecraftian metal	lovecraftian metal	1
louisiana metal	louisiana metal	1
british comedy	british comedy	1
deep adult standards	deep adult standards	1
swedish jazz orkester	swedish jazz orkester	1
progressive deathcore	progressive deathcore	1
florida hardcore	florida hardcore	1
electroacoustic improvisation	electroacoustic improvisation	1
middle eastern traditional	middle eastern traditional	1
police band	police band	1
melodic death metal	melodic death metal	1
progressive psytrance	progressive psytrance	1
polca paraguaya	polca paraguaya	1
dark jazz	dark jazz	1
seattle metal	seattle metal	1
polyphonies corses	polyphonies corses	1
instrumental post-rock	instrumental post-rock	1
finnish doom metal	finnish doom metal	1
italian death metal	italian death metal	1
denver metal	denver metal	1
vintage italian soundtrack	vintage italian soundtrack	1
taiko	taiko	1
canadian stoner rock	canadian stoner rock	1
abstractro	abstractro	1
children's story	children 's story	1
french death metal	french death metal	1
german grindcore	german grindcore	1
ugandan traditional	ugandan traditional	1
laboratorio	laboratorio	1
ethnotronica	ethnotronica	1
organic house	organic house	1
scorecore	scorecore	1
deep techno	deep techno	1
bajki	bajki	1
comedy	comedy	1
dark folk	dark folk	1
fourth world	fourth world	1
nitzhonot	nitzhonot	1
deathrash	deathrash	1
icelandic choir	icelandic choir	1
arab folk	arab folk	1
uilleann pipes	uilleann pipes	1
greek contemporary classical	greek contemporary classical	1
indian techno	indian techno	1
mathcore	mathcore	1
movie tunes	movie tunes	1
spanish jazz	spanish jazz	1
mevlevi sufi	mevlevi sufi	1
icelandic traditional	icelandic traditional	1
modern free jazz	modern free jazz	1
slack-key guitar	slack-key guitar	1
new wave of thrash metal	new wave of thrash metal	1
drone folk	drone folk	1
neo-crust	neo-crust	1
progressive sludge	progressive sludge	1
quebec death metal	quebec death metal	1
christian deathcore	christian deathcore	1
argentine ambient	argentine ambient	1
greek techno	greek techno	1
norwegian jazz	norwegian jazz	1
iranian experimental	iranian experimental	1
sound art	sound art	1
hungarian black metal	hungarian black metal	1
deep deep tech house	deep deep tech house	1
vintage schlager	vintage schlager	1
folk black metal	folk black metal	1
charred death	charred death	1
andalusian classical	andalusian classical	1
piano mpb	piano mpb	1
australian jazz	australian jazz	1
experimental poetry	experimental poetry	1
japanese death metal	japanese death metal	1
traditional country	traditional country	1
swedish death metal	swedish death metal	1
south carolina metal	south carolina metal	1
new age	new age	1
deep progressive house	deep progressive house	1
canadian metalcore	canadian metalcore	1
deep vocal jazz	deep vocal jazz	1
traditional blues	traditional blues	1
israeli jazz	israeli jazz	1
clean comedy	clean comedy	1
lowlands hardcore	lowlands hardcore	1
crossover thrash	crossover thrash	1
christmas instrumental	christmas instrumental	1
dark progressive house	dark progressive house	1
bulgarian electronic	bulgarian electronic	1
guitarra portuguesa	guitarra portuguesa	1
contemporary jazz	contemporary jazz	1
black sludge	black sludge	1
tzadik	tzadik	1
kantele	kantele	1
guidance	guidance	1
belgian techno	belgian techno	1
norwegian metal	norwegian metal	1
japanese choir	japanese choir	1
western swing	western swing	1
modern jazz trio	modern jazz trio	1
anthem	anthem	1
raw techno	raw techno	1
balalaika	balalaika	1
jaw harp	jaw harp	1
experimental ambient	experimental ambient	1
hindustani vocal	hindustani vocal	1
minimal tech house	minimal tech house	1
jota aragonesa	jota aragonesa	1
black metal argentino	black metal argentino	1
bulgarian folk	bulgarian folk	1
dutch experimental	dutch experimental	1
comedia	comedia	1
russian techno	russian techno	1
canadian hardcore	canadian hardcore	1
belgian jazz	belgian jazz	1
symphonic death metal	symphonic death metal	1
belgian death metal	belgian death metal	1
melodic techno	melodic techno	1
canadian comedy	canadian comedy	1
baptist gospel	baptist gospel	1
nyckelharpa	nyckelharpa	1
classify	classify	1
post-metal	post-metal	1
free folk	free folk	1
video game music	video game music	1
soul jazz	soul jazz	1
rosary	rosary	1
mountain dulcimer	mountain dulcimer	1
military cadence	military cadence	1
technical melodic death metal	technical melodic death metal	1
finnish death metal	finnish death metal	1
deep funk house	deep funk house	1
college marching band	college marching band	1
healing	healing	1
post-doom metal	post-doom metal	1
portland metal	portland metal	1
nyc metal	nyc metal	1
argentine jazz	argentine jazz	1
ghanaian traditional	ghanaian traditional	1
blackgaze	blackgaze	1
central asian folk	central asian folk	1
polish modern jazz	polish modern jazz	1
ambient	ambient	1
afghan traditional	afghan traditional	1
metal noir quebecois	metal noir quebecois	1
japanese traditional	japanese traditional	1
baltic black metal	baltic black metal	1
boogie-woogie	boogie-woogie	1
austrian techno	austrian techno	1
black thrash	black thrash	1
hangpan	hangpan	1
italian jazz	italian jazz	1
fingerstyle	fingerstyle	1
dungeon synth	dungeon synth	1
easy listening	easy listening	1
visor	visor	1
cante flamenco	cante flamenco	1
noisecore	noisecore	1
cosmic post-rock	cosmic post-rock	1
jazz double bass	jazz double bass	1
chinese soundtrack	chinese soundtrack	1
dark minimal techno	dark minimal techno	1
swedish hardcore	swedish hardcore	1
free improvisation	free improvisation	1
peruvian death metal	peruvian death metal	1
appalachian folk	appalachian folk	1
french jazz	french jazz	1
death 'n' roll	death 'n ' roll	1
utah metal	utah metal	1
lullaby	lullaby	1
danish death metal	danish death metal	1
ukrainian black metal	ukrainian black metal	1
jazz trumpet	jazz trumpet	1
bothy ballad	bothy ballad	1
swedish experimental	swedish experimental	1
grisly death metal	grisly death metal	1
japanese instrumental	japanese instrumental	1
drone metal	drone metal	1
lounge	lounge	1
italian black metal	italian black metal	1
jazz saxophone	jazz saxophone	1
portuguese black metal	portuguese black metal	1
depressive black metal	depressive black metal	1
modern electroacoustic	modern electroacoustic	1
string folk	string folk	1
japanese concert band	japanese concert band	1
jazz harp	jazz harp	1
sarod	sarod	1
yiddish folk	yiddish folk	1
psychedelic space rock	psychedelic space rock	1
nordic post-rock	nordic post-rock	1
serbian electronic	serbian electronic	1
russian folk	russian folk	1
hard techno	hard techno	1
taiwan instrumental	taiwan instrumental	1
brazilian doom metal	brazilian doom metal	1
bahamian folk	bahamian folk	1
yemeni traditional	yemeni traditional	1
death metal	death metal	1
mexican death metal	mexican death metal	1
jazz blues	jazz blues	1
dhrupad	dhrupad	1
new comedy	new comedy	1
jazz guitar	jazz guitar	1
beat poetry	beat poetry	1
blackened hardcore	blackened hardcore	1
british electroacoustic	british electroacoustic	1
classical clarinet	classical clarinet	1
blasmusik	blasmusik	1
persian neo-traditional	persian neo-traditional	1
emoviolence	emoviolence	1
yodeling	yodeling	1
danish hardcore	danish hardcore	1
vintage spanish pop	vintage spanish pop	1
folclore navarra	folclore navarra	1
free jazz	free jazz	1
latin soundtrack	latin soundtrack	1
oud	oud	1
polish death metal	polish death metal	1
portuguese techno	portuguese techno	1
french soundtrack	french soundtrack	1
techno argentina	techno argentina	1
irish fiddle	irish fiddle	1
instrumental death metal	instrumental death metal	1
cornetas y tambores	cornetas y tambores	1
carnatic vocal	carnatic vocal	1
vietnamese traditional	vietnamese traditional	1
symphonic black metal	symphonic black metal	1
czsk black metal	czsk black metal	1
copla	copla	1
musikkorps	musikkorps	1
classical jazz fusion	classical jazz fusion	1
shantykoren	shantykoren	1
nordic soundtrack	nordic soundtrack	1
technical deathcore	technical deathcore	1
uk post-metal	uk post-metal	1
jazz brass	jazz brass	1
marching band	marching band	1
navajo	navajo	1
re:techno	re : techno	1
rabindra sangeet	rabindra sangeet	1
jazz quartet	jazz quartet	1
progressive black metal	progressive black metal	1
dark techno	dark techno	1
vintage italian pop	vintage italian pop	1
british black metal	british black metal	1
bansuri	bansuri	1
chaotic hardcore	chaotic hardcore	1
lowercase	lowercase	1
spanish techno	spanish techno	1
classical mandolin	classical mandolin	1
acoustic blues	acoustic blues	1
avant-garde jazz	avant-garde jazz	1
mathgrind	mathgrind	1
italian post-rock	italian post-rock	1
death industrial	death industrial	1
psytech	psytech	1
florida death metal	florida death metal	1
american primitive	american primitive	1
italian soundtrack	italian soundtrack	1
melodic black metal	melodic black metal	1
uk tech house	uk tech house	1
deep deep house	deep deep house	1
technical brutal death metal	technical brutal death metal	1
black 'n' roll	black 'n ' roll	1
swiss techno	swiss techno	1
slamming deathcore	slamming deathcore	1
progressive technical death metal	progressive technical death metal	1
austrian black metal	austrian black metal	1
persian traditional	persian traditional	1
cinematic post-rock	cinematic post-rock	1
goa psytrance	goa psytrance	1
goregrind	goregrind	1
ritual ambient	ritual ambient	1
chaotic black metal	chaotic black metal	1
prank	prank	1
jazz trombone	jazz trombone	1
drama	drama	1
metal cearense	metal cearense	1
fan chant	fan chant	1
autonomous black metal	autonomous black metal	1
brazilian composition	brazilian composition	1
women's choir	women 's choir	1
pops orchestra	pops orchestra	1
brazilian black metal	brazilian black metal	1
italian techno	italian techno	1
microtonal	microtonal	1
colombian black metal	colombian black metal	1
vintage hawaiian	vintage hawaiian	1
deep symphonic black metal	deep symphonic black metal	1
atmospheric black metal	atmospheric black metal	1
viking black metal	viking black metal	1
jazz	jazz	1
contemporary post-bop	contemporary post-bop	1
new zealand classical	new zealand classical	1
delta blues	delta blues	1
nordic ambient	nordic ambient	1
classical trumpet	classical trumpet	1
japanese classical	japanese classical	1
hard bop	hard bop	1
brazilian grindcore	brazilian grindcore	1
bebop	bebop	1
straight-ahead jazz	straight-ahead jazz	1
cool jazz	cool jazz	1
classical accordion	classical accordion	1
bengali folk	bengali folk	1
korean traditional	korean traditional	1
new orleans jazz	new orleans jazz	1
vintage gospel	vintage gospel	1
chilean black metal	chilean black metal	1
black speed metal	black speed metal	1
british death metal	british death metal	1
ancient mediterranean	ancient mediterranean	1
symphonic melodic death metal	symphonic melodic death metal	1
epic black metal	epic black metal	1
nuevo tango	nuevo tango	1
brazilian death metal	brazilian death metal	1
cante alentejano	cante alentejano	1
israeli techno	israeli techno	1
post-black metal	post-black metal	1
jazz clarinet	jazz clarinet	1
motivation	motivation	1
sludgecore	sludgecore	1
brazilian techno	brazilian techno	1
brutal death metal	brutal death metal	1
operatic pop	operatic pop	1
hoerspiel	hoerspiel	1
relaxative	relaxative	1
deep minimal techno	deep minimal techno	1
comedienne	comedienne	1
jugendchor	jugendchor	1
vocal jazz	vocal jazz	1
vocal harmony group	vocal harmony group	1
greek black metal	greek black metal	1
polish free jazz	polish free jazz	1
spanish black metal	spanish black metal	1
swedish black metal	swedish black metal	1
big band	big band	1
irish contemporary classical	irish contemporary classical	1
dixieland	dixieland	1
american folk revival	american folk revival	1
dizi	dizi	1
british soundtrack	british soundtrack	1
technical death metal	technical death metal	1
dutch death metal	dutch death metal	1
field recording	field recording	1
drone	drone	1
irish flute	irish flute	1
german dark minimal techno	german dark minimal techno	1
military band	military band	1
harp	harp	1
african-american classical	african-american classical	1
black metal	black metal	1
cambodian traditional	cambodian traditional	1
vintage radio show	vintage radio show	1
focus trance	focus trance	1
german black metal	german black metal	1
classic soundtrack	classic soundtrack	1
instrumental acoustic guitar	instrumental acoustic guitar	1
canadian black metal	canadian black metal	1
trad jazz catala	trad jazz catala	1
italian contemporary jazz	italian contemporary jazz	1
ecm-style jazz	ecm-style jazz	1
norwegian folk	norwegian folk	1
burmese traditional	burmese traditional	1
swing	swing	1
turkish classical	turkish classical	1
mexican tech house	mexican tech house	1
jazz piano	jazz piano	1
japanese black metal	japanese black metal	1
swiss house	swiss house	1
piedmont blues	piedmont blues	1
country blues	country blues	1
hula	hula	1
vintage finnish jazz	vintage finnish jazz	1
norwegian death metal	norwegian death metal	1
german soundtrack	german soundtrack	1
danish black metal	danish black metal	1
barnsagor	barnsagor	1
gypsy jazz	gypsy jazz	1
classical percussion	classical percussion	1
house argentino	house argentino	1
slam death metal	slam death metal	1
gospel blues	gospel blues	1
chinese traditional	chinese traditional	1
santur	santur	1
cosmic black metal	cosmic black metal	1
pagan black metal	pagan black metal	1
deep tech house	deep tech house	1
electroacoustic composition	electroacoustic composition	1
komedi	komedi	1
musique concrete	musique concrete	1
dutch black metal	dutch black metal	1
french tech house	french tech house	1
technical grindcore	technical grindcore	1
russian black metal	russian black metal	1
tango	tango	1
italian tech house	italian tech house	1
norwegian black metal	norwegian black metal	1
stride	stride	1
vintage swing	vintage swing	1
stubenmusik	stubenmusik	1
spanish classical	spanish classical	1
acousmatic	acousmatic	1
german tech house	german tech house	1
irish gaelic folk	irish gaelic folk	1
modern jazz piano	modern jazz piano	1
medieval ensemble	medieval ensemble	1
deep comedy	deep comedy	1
deep ambient	deep ambient	1
music hall	music hall	1
bandoneon	bandoneon	1
soundtrack	soundtrack	1
oceania soundtrack	oceania soundtrack	1
pibroch	pibroch	1
polyphony	polyphony	1
swedish fiddle	swedish fiddle	1
zither	zither	1
torch song	torch song	1
lao traditional	lao traditional	1
belgian black metal	belgian black metal	1
french black metal	french black metal	1
grindcore	grindcore	1
erhu	erhu	1
jazz trio	jazz trio	1
icelandic black metal	icelandic black metal	1
rakugo	rakugo	1
black death	black death	1
dinner jazz	dinner jazz	1
usbm	usbm	1
chant religieux	chant religieux	1
harlem renaissance	harlem renaissance	1
kapa haka	kapa haka	1
canadian soundtrack	canadian soundtrack	1
polish black metal	polish black metal	1
poetry	poetry	1
ballet class	ballet class	1
new york death metal	new york death metal	1
kentucky mountain folk	kentucky mountain folk	1
finnish black metal	finnish black metal	1
spirituals	spirituals	1
oratory	oratory	1
dark black metal	dark black metal	1
tanzlmusi	tanzlmusi	1
modern performance	modern performance	1
thai traditional	thai traditional	1
british grindcore	british grindcore	1
tajik traditional	tajik traditional	1
ambient black metal	ambient black metal	1
vaudeville	vaudeville	1
kaba gaida	kaba gaida	1
deathgrind	deathgrind	1
latin classical	latin classical	1
deep soundtrack	deep soundtrack	1
mexican black metal	mexican black metal	1
voidgaze	voidgaze	1
australian black metal	australian black metal	1
hardingfele	hardingfele	1
ragtime	ragtime	1
brass ensemble	brass ensemble	1
black noise	black noise	1
tin pan alley	tin pan alley	1
nu age	nu age	1
latin tech house	latin tech house	1
harpsichord	harpsichord	1
light music	light music	1
sound effects	sound effects	1
icelandic classical	icelandic classical	1
swedish grindcore	swedish grindcore	1
orquesta tipica	orquesta tipica	1
calming instrumental	calming instrumental	1
recorder	recorder	1
cantonese traditional	cantonese traditional	1
vintage jazz	vintage jazz	1
irish ballad	irish ballad	1
tar	tar	1
belgian contemporary classical	belgian contemporary classical	1
compositional ambient	compositional ambient	1
wind ensemble	wind ensemble	1
instrumental black metal	instrumental black metal	1
post-minimalism	post-minimalism	1
gayageum	gayageum	1
bemani	bemani	1
british orchestra	british orchestra	1
singing bowl	singing bowl	1
traditional irish singing	traditional irish singing	1
cryptic black metal	cryptic black metal	1
d-beat	d-beat	1
binaural	binaural	1
reading	reading	1
technical black metal	technical black metal	1
vintage chanson	vintage chanson	1
therapy	therapy	1
world meditation	world meditation	1
jug band	jug band	1
blackened crust	blackened crust	1
ryukoka	ryukoka	1
austrian contemporary classical	austrian contemporary classical	1
cascadian black metal	cascadian black metal	1
musica de fondo	musica de fondo	1
syro-aramaic chant	syro-aramaic chant	1
vintage hollywood	vintage hollywood	1
asmr	asmr	1
focus	focus	1
hard minimal techno	hard minimal techno	1
uzbek traditional	uzbek traditional	1
deep delta blues	deep delta blues	1
british dance band	british dance band	1
musica antigua	musica antigua	1
cabaret	cabaret	1
shush	shush	1
pipa	pipa	1
classical oboe	classical oboe	1
concert band	concert band	1
celtic harp	celtic harp	1
orchestra	orchestra	1
vintage tango	vintage tango	1
italian tenor	italian tenor	1
classical baritone	classical baritone	1
new age piano	new age piano	1
classical flute	classical flute	1
native american flute	native american flute	1
brain waves	brain waves	1
glass	glass	1
sleep	sleep	1
minimalism	minimalism	1
vintage country folk	vintage country folk	1
oriental classical	oriental classical	1
war metal	war metal	1
classical saxophone	classical saxophone	1
moravian folk	moravian folk	1
guided meditation	guided meditation	1
bible	bible	1
quran	quran	1
albanian iso polyphony	albanian iso polyphony	1
american romanticism	american romanticism	1
american modern classical	american modern classical	1
tango cancion	tango cancion	1
warm drone	warm drone	1
guitarra argentina	guitarra argentina	1
dutch contemporary classical	dutch contemporary classical	1
modern string quartet	modern string quartet	1
kyrgyz traditional	kyrgyz traditional	1
avant-garde	avant-garde	1
cavernous death metal	cavernous death metal	1
american orchestra	american orchestra	1
german literature	german literature	1
norwegian choir	norwegian choir	1
spanish contemporary classical	spanish contemporary classical	1
islamic recitation	islamic recitation	1
meditation	meditation	1
marimba	marimba	1
zen	zen	1
hypnosis	hypnosis	1
marcha funebre	marcha funebre	1
german baroque	german baroque	1
historically informed performance	historically informed performance	1
string orchestra	string orchestra	1
french orchestra	french orchestra	1
bells	bells	1
drift	drift	1
rominimal	rominimal	1
baroque	baroque	1
spa	spa	1
canto a tenore	canto a tenore	1
vintage old-time	vintage old-time	1
early music	early music	1
handbells	handbells	1
neo-classical	neo-classical	1
classical countertenor	classical countertenor	1
background music	background music	1
latin american baroque	latin american baroque	1
italian baroque	italian baroque	1
american contemporary classical	american contemporary classical	1
operetta	operetta	1
white noise	white noise	1
korean classical performance	korean classical performance	1
early music ensemble	early music ensemble	1
austrian choir	austrian choir	1
voidgrind	voidgrind	1
portuguese contemporary classical	portuguese contemporary classical	1
classical mezzo-soprano	classical mezzo-soprano	1
french baroque	french baroque	1
danish contemporary classical	danish contemporary classical	1
historical keyboard	historical keyboard	1
welsh choir	welsh choir	1
british contemporary classical	british contemporary classical	1
swedish contemporary classical	swedish contemporary classical	1
french contemporary classical	french contemporary classical	1
classical bass	classical bass	1
italian baritone	italian baritone	1
baroque singing	baroque singing	1
classical horn	classical horn	1
contemporary classical piano	contemporary classical piano	1
massage	massage	1
english baroque	english baroque	1
classical bassoon	classical bassoon	1
german contemporary classical	german contemporary classical	1
british brass band	british brass band	1
pianissimo	pianissimo	1
italian soprano	italian soprano	1
swiss contemporary classical	swiss contemporary classical	1
hungarian contemporary classical	hungarian contemporary classical	1
mindfulness	mindfulness	1
birdsong	birdsong	1
czech contemporary classical	czech contemporary classical	1
brass quintet	brass quintet	1
german choir	german choir	1
medieval	medieval	1
wandelweiser	wandelweiser	1
spanish baroque	spanish baroque	1
trallalero	trallalero	1
chakra	chakra	1
italian bass	italian bass	1
shakuhachi	shakuhachi	1
baroque ensemble	baroque ensemble	1
classical performance	classical performance	1
vocal ensemble	vocal ensemble	1
chamber ensemble	chamber ensemble	1
classical tenor	classical tenor	1
orchestral performance	orchestral performance	1
classical saxophone quartet	classical saxophone quartet	1
french opera	french opera	1
israeli classical	israeli classical	1
canadian classical	canadian classical	1
yoga	yoga	1
chinese classical	chinese classical	1
contemporary classical	contemporary classical	1
byzantine	byzantine	1
koto	koto	1
portuguese early music	portuguese early music	1
choral	choral	1
baroque violin	baroque violin	1
french renaissance	french renaissance	1
radio symphony	radio symphony	1
string quartet	string quartet	1
polish contemporary classical	polish contemporary classical	1
italian contemporary classical	italian contemporary classical	1
lesen	lesen	1
men's choir	men 's choir	1
galante era	galante era	1
romanian contemporary classical	romanian contemporary classical	1
chamber orchestra	chamber orchestra	1
dronescape	dronescape	1
japanese classical performance	japanese classical performance	1
contrabass	contrabass	1
russian modern classical	russian modern classical	1
tone	tone	1
viol	viol	1
violin	violin	1
drone ambient	drone ambient	1
environmental	environmental	1
bohemian baroque	bohemian baroque	1
russian contemporary classical	russian contemporary classical	1
classical	classical	1
pet calming	pet calming	1
contemporary choir	contemporary choir	1
polish choir	polish choir	1
irish classical	irish classical	1
university choir	university choir	1
australian classical	australian classical	1
guzheng	guzheng	1
quatuor a cordes	quatuor a cordes	1
classical organ	classical organ	1
early avant garde	early avant garde	1
american choir	american choir	1
lute	lute	1
sound	sound	1
guqin	guqin	1
classical soprano	classical soprano	1
spanish renaissance	spanish renaissance	1
historic orchestral performance	historic orchestral performance	1
nordic contemporary classical	nordic contemporary classical	1
water	water	1
reiki	reiki	1
oxford choir	oxford choir	1
opera	opera	1
serialism	serialism	1
english renaissance	english renaissance	1
mexican classical	mexican classical	1
chinese classical performance	chinese classical performance	1
monastic	monastic	1
late romantic era	late romantic era	1
neoclassicism	neoclassicism	1
early modern classical	early modern classical	1
german opera	german opera	1
russian romanticism	russian romanticism	1
renaissance	renaissance	1
classical harp	classical harp	1
classical guitar	classical guitar	1
cambridge choir	cambridge choir	1
classical trombone	classical trombone	1
german renaissance	german renaissance	1
korean contemporary classical	korean contemporary classical	1
baltic classical	baltic classical	1
swedish classical	swedish classical	1
classical era	classical era	1
vintage classical singing	vintage classical singing	1
austro-german modernism	austro-german modernism	1
franco-flemish school	franco-flemish school	1
euphonium	euphonium	1
victorian britain	victorian britain	1
youth orchestra	youth orchestra	1
classical cello	classical cello	1
chill guitar	chill guitar	1
italian opera	italian opera	1
piano cover	piano cover	1
british choir	british choir	1
tanci	tanci	1
early romantic era	early romantic era	1
classical piano duo	classical piano duo	1
british modern classical	british modern classical	1
viola	viola	1
anglican liturgy	anglican liturgy	1
boy soprano	boy soprano	1
post-romantic era	post-romantic era	1
classical piano	classical piano	1
italian mezzo-soprano	italian mezzo-soprano	1
opera chorus	opera chorus	1
finnish contemporary classical	finnish contemporary classical	1
classical tuba	classical tuba	1
italian renaissance	italian renaissance	1
danish choir	danish choir	1
polish early music	polish early music	1
georgian polyphony	georgian polyphony	1
norwegian classical	norwegian classical	1
danish classical	danish classical	1
chinese opera	chinese opera	1
orthodox chant	orthodox chant	1
australian choir	australian choir	1
chamber choir	chamber choir	1
classical piano trio	classical piano trio	1
finnish choir	finnish choir	1
baltic choir	baltic choir	1
impressionism	impressionism	1
historic string quartet	historic string quartet	1
finnish classical	finnish classical	1
atmosphere	atmosphere	1
classical contralto	classical contralto	1
historic classical performance	historic classical performance	1
psalmen	psalmen	1
classical guitar duo	classical guitar duo	1
early music choir	early music choir	1
classical string trio	classical string trio	1
jewish cantorial	jewish cantorial	1
swedish choir	swedish choir	1
historic piano performance	historic piano performance	1
canadian choir	canadian choir	1
classical guitar quartet	classical guitar quartet	1
cathedral choir	cathedral choir	1
ukrainian classical	ukrainian classical	1
polish classical	polish classical	1
italian choir	italian choir	1
ukrainian choir	ukrainian choir	1
wind quintet	wind quintet	1
