a dana das borboletas	a dana das borboletas	1
adolescente	adolescente	1
adorable	adorable	1
a gif database that debuted in february	a gif database that debuted in february	1
i did not get any results . they did	i did not get any results . they did	1
al yankovic	al yankovic	1
amy poehler	amy poehler	1
an ai alliance	an ai alliance	1
and considerable momentum	and considerable momentum	1
and the more viral they become	and the more viral they become	1
aside from excited sue or whatever	aside from excited sue or whatever	1
ask me	ask me	1
so who actually created the gif	so who actually created the gif	1
assemblee nationale	assemblee nationale	1
austenedit	austenedit	1
beach	beach	1
beast king golion	beast king golion	1
beautiful	beautiful	1
beauty	beauty	1
best	best	1
best post of all time	best post of all time	1
beyonce	beyonce	1
boy	boy	1
boys	boys	1
brandon harrel	brandon harrel	1
bro	bro	1
broarmy	broarmy	1
bro army	bro army	1
bro family	bro family	1
brofist	brofist	1
bro fist	bro fist	1
bros	bros	1
bro tag	bro tag	1
but i see popular comics get posted with the lol tag	but i see popular comics get posted with the lol tag	1
cat	cat	1
cats	cats	1
cctv	cctv	1
choreography	choreography	1
closing time	closing time	1
continues to make improvements and new features	continues to make improvements and new features	1
creepy	creepy	1
crew	crew	1
cts	cts	1
cute	cute	1
dance	dance	1
digital	digital	1
doctor who	doctor who	1
dolce gabbana	dolce gabbana	1
dt	dt	1
dt product reviews latest	dt product reviews latest	1
eighth doctor	eighth doctor	1
eleventh doctor	eleventh doctor	1
elisabeth bennet	elisabeth bennet	1
eli wallach	eli wallach	1
experiment	experiment	1
felix	felix	1
felix kjellberg	felix kjellberg	1
follome	follome	1
follow	follow	1
followback	followback	1
followme	followme	1
friend	friend	1
funny	funny	1
game	game	1
game s	game s	1
games s	games s	1
gato	gato	1
gay	gay	1
gays	gays	1
getweirdaltonumberone	getweirdaltonumberone	1
gif	gif	1
girl	girl	1
girls	girls	1
gostosa	gostosa	1
gostoso	gostoso	1
great	great	1
gtkm meme	gtkm meme	1
halo	halo	1
headlikeanorange	headlikeanorange	1
hello	hello	1
hete	hete	1
how do you tag thingsm	how do you tag thingsm	1
however	however	1
how we test awards we offer	how we test awards we offer	1
iamme	iamme	1
i am me	i am me	1
iammecrew	iammecrew	1
i am me crew	i am me crew	1
i dont know	i dont know	1
interact	interact	1
jaja	jaja	1
jaja vankova	jaja vankova	1
jared padalecki	jared padalecki	1
justin bieber	justin bieber	1
karma	karma	1
katy perry	katy perry	1
keira knightley	keira knightley	1
kjellberg	kjellberg	1
lady	lady	1
lenovo thinkpad x260	lenovo thinkpad x260	1
lol at the tags but its it	lol at the tags but its it	1
love quotes	love quotes	1
make me	make me	1
mandatory fun	mandatory fun	1
mariage homo	mariage homo	1
mariagepourtous	mariagepourtous	1
mariage pour tous	mariage pour tous	1
matt smith	matt smith	1
maya rudolph	maya rudolph	1
mean see all editors ' choice	mean see all editors ' choice	1
metal	metal	1
mitchelll	mitchelll	1
mpb	mpb	1
mr darcy	mr darcy	1
mrw	mrw	1
musica popular brasileira	musica popular brasileira	1
musk eyes mars	musk eyes mars	1
my life is just rying to figure popular tags out	my life is just rying to figure popular tags out	1
name	name	1
new	new	1
new year	new year	1
nintendo	nintendo	1
no	no	1
oh	oh	1
one direction	one direction	1
opposition	opposition	1
ora	ora	1
original	original	1
or you could use a keyword and browse through tumblr	or you could use a keyword and browse through tumblr	1
pacman	pacman	1
part of my thumb -lrb- this is going to be a popular tag -rrb-	part of my thumb -lrb- this is going to be a popular tag -rrb-	1
paul mcgann	paul mcgann	1
pewdie	pewdie	1
pewdiepie	pewdiepie	1
pewds	pewds	1
pis popular posts	pis popular posts	1
pop	pop	1
popular	popular	1
popular tags	popular tags	1
presente	presente	1
pride and prejudice	pride and prejudice	1
pride prejudice	pride prejudice	1
reaction s	reaction s	1
rebeldia	rebeldia	1
references and parallels	references and parallels	1
rita	rita	1
rita ora	rita ora	1
samsung gear s2	samsung gear s2	1
samus	samus	1
school	school	1
sepultura	sepultura	1
snl	snl	1
so i thought why not	so i thought why not	1
sort	sort	1
sparkler	sparkler	1
subtly inserts popular tumblr tag	subtly inserts popular tumblr tag	1
summer	summer	1
tag	tag	1
tags	tags	1
tagsforfollowers	tagsforfollowers	1
tagsforreblogs	tagsforreblogs	1
taylor swift	taylor swift	1
the further they get from their origin	the further they get from their origin	1
the most important snl sketch	the most important snl sketch	1
the movie	the movie	1
there are sites like gifsoup	there are sites like gifsoup	1
the view	the view	1
this makes me	this makes me	1
thor the dark world	thor the dark world	1
though . in the past	though . in the past	1
thrash metal	thrash metal	1
to evolve the way we consume	to evolve the way we consume	1
tomodachi life	tomodachi life	1
trends	trends	1
tyler sash	tyler sash	1
uhf	uhf	1
ump	ump	1
vanessa rousso	vanessa rousso	1
viral	viral	1
voltron	voltron	1
weird al	weird al	1
weird al yankovic	weird al yankovic	1
what our review scores	what our review scores	1
with a clean interface . you can enter your keyword into a search box	with a clean interface . you can enter your keyword into a search box	1
without rules	without rules	1
x	x	1
z ramalho	z ramalho	1
