clickbait-corrected p-value	clickbait-corrected p-value	1
selection effect	selection effect	1
gdpr	gdpr	1
business update	business update	1
morning news	morning news	1
mc hammer age	mc hammer age	1
repairs	repairs	1
fatal crash rate	fatal crash rate	1
safetysat	safetysat	1
research areas by size and countedness	research areas by size and countedness	1
driving cars	driving cars	1
imho	imho	1
containers	containers	1
python environment	python environment	1
river border	river border	1
meteorologist	meteorologist	1
misinterpretation	misinterpretation	1
clutter	clutter	1
evangelism	evangelism	1
rickrolling anniversary	rickrolling anniversary	1
history	history	1
congressional testimony	congressional testimony	1
paperwork	paperwork	1
friendly questions	friendly questions	1
right click	right click	1
conversational dynamics	conversational dynamics	1
star lore	star lore	1
autogyros	autogyros	1
personal data	personal data	1
name dominoes	name dominoes	1
not available	not available	1
robot future	robot future	1
violin plots	violin plots	1
smart home security	smart home security	1
background apps	background apps	1
spatial orientation	spatial orientation	1
namespace land rush	namespace land rush	1
generations	generations	1
interaction	interaction	1
code golf	code golf	1
the simpsons	the simpsons	1
self-driving issues	self-driving issues	1
unification	unification	1
robots	robots	1
impostor syndrome	impostor syndrome	1
the history of unicode	the history of unicode	1
backpack decisions	backpack decisions	1
super bowl watch party	super bowl watch party	1
chicken pox and name statistics	chicken pox and name statistics	1
fruit collider	fruit collider	1
campaign fundraising emails	campaign fundraising emails	1
night sky	night sky	1
scientific paper graph quality	scientific paper graph quality	1
the end of the rainbow	the end of the rainbow	1
universal dreams	universal dreams	1
memorable quotes	memorable quotes	1
dying gift	dying gift	1
the food size cycle	the food size cycle	1
meltdown and spectre	meltdown and spectre	1
iata airport abbreviations	iata airport abbreviations	1
desert golfing	desert golfing	1
phone security	phone security	1
the true meaning of christmas	the true meaning of christmas	1
virtual assistant	virtual assistant	1
calendar facts	calendar facts	1
argument timing	argument timing	1
tinder	tinder	1
bad code	bad code	1
self-driving car milestones	self-driving car milestones	1
solar panels	solar panels	1
felsius	felsius	1
interferometry	interferometry	1
emoji sports	emoji sports	1
interstellar asteroid	interstellar asteroid	1
nexus	nexus	1
how to make friends	how to make friends	1
temperature preferences	temperature preferences	1
nightmare email feature	nightmare email feature	1
twitter verification	twitter verification	1
a	a	1
thermostat	thermostat	1
defensive profile	defensive profile	1
sky spotters	sky spotters	1
digital resource lifespan	digital resource lifespan	1
credit card rewards	credit card rewards	1
immune system	immune system	1
making progress	making progress	1
cast iron pan	cast iron pan	1
research risks	research risks	1
bun trend	bun trend	1
state borders	state borders	1
logical	logical	1
jet lag	jet lag	1
ears	ears	1
self driving	self driving	1
active ingredients only	active ingredients only	1
worrying scientist interviews	worrying scientist interviews	1
real estate	real estate	1
thread	thread	1
usb cables	usb cables	1
obsolete technology	obsolete technology	1
what to bring	what to bring	1
still in use	still in use	1
two down , one to go	two down , one to go	1
typing notifications	typing notifications	1
ensemble model	ensemble model	1
ringer volume/media volume	ringer volume/media volume	1
supervillain plan	supervillain plan	1
color models	color models	1
drone training	drone training	1
eclipse review	eclipse review	1
eclipse birds	eclipse birds	1
earth orbital diagram	earth orbital diagram	1
eclipse science	eclipse science	1
eclipse searches	eclipse searches	1
computers vs humans	computers vs humans	1
geologic faults	geologic faults	1
email reply	email reply	1
backup batteries	backup batteries	1
bun alert	bun alert	1
emoji movie reviews	emoji movie reviews	1
positive and negative reviews	positive and negative reviews	1
eclipse flights	eclipse flights	1
physics confession	physics confession	1
russell 's teapot	russell 's teapot	1
wifi vs cellular	wifi vs cellular	1
city nicknames	city nicknames	1
screenshots	screenshots	1
particle properties	particle properties	1
quantum	quantum	1
communicating	communicating	1
sports knowledge	sports knowledge	1
4 th of july	4 th of july	1
emoji movie	emoji movie	1
existence proof	existence proof	1
telephoto	telephoto	1
refresh types	refresh types	1
once per day	once per day	1
election map	election map	1
magnetohydrodynamics	magnetohydrodynamics	1
air force museum	air force museum	1
decades	decades	1
glacial erratic	glacial erratic	1
dubious study	dubious study	1
drone problems	drone problems	1
state word map	state word map	1
voting systems	voting systems	1
opening crawl	opening crawl	1
anti-drone eagles	anti-drone eagles	1
who ?	who ?	1
genetic testing results	genetic testing results	1
doctor visit	doctor visit	1
machine learning	machine learning	1
rental car	rental car	1
okeanos	okeanos	1
random obsessions	random obsessions	1
lunch order	lunch order	1
photo library management	photo library management	1
here to help	here to help	1
geochronology	geochronology	1
iss solar transit	iss solar transit	1
survivorship bias	survivorship bias	1
birdwatching	birdwatching	1
identification chart	identification chart	1
hottest editors	hottest editors	1
existential bug reports	existential bug reports	1
incinerator	incinerator	1
security advice	security advice	1
rayleigh scattering	rayleigh scattering	1
incognito mode	incognito mode	1
mispronunciation	mispronunciation	1
flag	flag	1
color pattern	color pattern	1
vomiting emoji	vomiting emoji	1
onboarding	onboarding	1
best-tasting colors	best-tasting colors	1
chat systems	chat systems	1
hacking	hacking	1
listening	listening	1
borrow your laptop	borrow your laptop	1
unpublished discoveries	unpublished discoveries	1
video content	video content	1
location reviews	location reviews	1
phone	phone	1
decision paralysis	decision paralysis	1
chess notation	chess notation	1
bad map projection : time zones	bad map projection : time zones	1
box plot	box plot	1
stardew valley	stardew valley	1
focus knob	focus knob	1
all you can eat	all you can eat	1
fire	fire	1
soda sugar comparisons	soda sugar comparisons	1
bird/plane/superman	bird/plane/superman	1
telescopes : refractor vs reflector	telescopes : refractor vs reflector	1
sad	sad	1
phone numbers	phone numbers	1
barge	barge	1
voice commands	voice commands	1
trash	trash	1
wifi	wifi	1
bad map projection : liquid resize	bad map projection : liquid resize	1
emails	emails	1
team chat	team chat	1
artifacts	artifacts	1
appliance repair	appliance repair	1
interest timescales	interest timescales	1
dear diary	dear diary	1
reindeer	reindeer	1
things you learn	things you learn	1
adjective foods	adjective foods	1
negativity	negativity	1
startup opportunity	startup opportunity	1
it was i	it was i	1
ui change	ui change	1
never seen star wars	never seen star wars	1
settling	settling	1
us state names	us state names	1
baby post	baby post	1
xkcde	xkcde	1
catcalling	catcalling	1
moving boxes	moving boxes	1
blame	blame	1
tv problems	tv problems	1
british map	british map	1
astrophysics	astrophysics	1
i 'm with her	i 'm with her	1
old days	old days	1
tornado safety tips	tornado safety tips	1
thumb war	thumb war	1
interplanetary experience	interplanetary experience	1
movie folder	movie folder	1
life goals	life goals	1
mushrooms	mushrooms	1
future archaeology	future archaeology	1
spider paleontology	spider paleontology	1
making friends	making friends	1
record scratch	record scratch	1
metabolism	metabolism	1
coffee	coffee	1
will it work	will it work	1
work	work	1
rosetta	rosetta	1
fixing problems	fixing problems	1
moon shapes	moon shapes	1
datacenter scale	datacenter scale	1
fashion police and grammar police	fashion police and grammar police	1
reductionism	reductionism	1
solar spectrum	solar spectrum	1
earth temperature timeline	earth temperature timeline	1
wrong	wrong	1
starshade	starshade	1
migrating geese	migrating geese	1
cron mail	cron mail	1
number of computers	number of computers	1
unicode	unicode	1
linear regression	linear regression	1
proofs	proofs	1
meteorite identification	meteorite identification	1
debugging	debugging	1
business idea	business idea	1
horses	horses	1
superzoom	superzoom	1
backups	backups	1
pyramid honey	pyramid honey	1
time travel thesis	time travel thesis	1
household tips	household tips	1
politifact	politifact	1
snapchat	snapchat	1
walking into things	walking into things	1
inflection	inflection	1
dehydration	dehydration	1
genetic testing	genetic testing	1
pokémon go	pokémon go	1
gnome ann	gnome ann	1
juno	juno	1
home itch remedies	home itch remedies	1
speed and danger	speed and danger	1
new bug	new bug	1
local news	local news	1
theft quadrants	theft quadrants	1
intervocalic fortition	intervocalic fortition	1
ai research	ai research	1
phishing license	phishing license	1
oxidation	oxidation	1
man page	man page	1
optimization	optimization	1
time-tracking software	time-tracking software	1
my friend catherine	my friend catherine	1
map age guide	map age guide	1
world war iii +	world war iii +	1
feel old	feel old	1
patch	patch	1
rainbow	rainbow	1
digital data	digital data	1
bun	bun	1
laser products	laser products	1
black hole	black hole	1
recent searches	recent searches	1
contrails	contrails	1
full-width justification	full-width justification	1
message in a bottle	message in a bottle	1
adult	adult	1
timeline of bicycle design	timeline of bicycle design	1
arcane bullshit	arcane bullshit	1
laws of physics	laws of physics	1
planespotting	planespotting	1
singularity	singularity	1
algorithms	algorithms	1
brain upload	brain upload	1
city talk pages	city talk pages	1
mycology	mycology	1
garden	garden	1
jack and jill	jack and jill	1
podium	podium	1
captain speaking	captain speaking	1
tire swing	tire swing	1
estimating time	estimating time	1
insanity	insanity	1
it begins	it begins	1
doomsday clock	doomsday clock	1
universal install script	universal install script	1
conditionals	conditionals	1
robotic garage	robotic garage	1
baby	baby	1
pipelines	pipelines	1
famous duos	famous duos	1
diacritics	diacritics	1
twitter bot	twitter bot	1
toasts	toasts	1
stargazing	stargazing	1
degrees	degrees	1
gravitational waves	gravitational waves	1
hot dogs	hot dogs	1
super bowl context	super bowl context	1
to taste	to taste	1
backslashes	backslashes	1
salt mine	salt mine	1
xkcd stack	xkcd stack	1
birdsong	birdsong	1
in case of emergency	in case of emergency	1
possible undiscovered planets	possible undiscovered planets	1
palindrome	palindrome	1
longer than usual	longer than usual	1
quadcopter	quadcopter	1
tools	tools	1
magnus	magnus	1
woosh	woosh	1
judgment day	judgment day	1
henge	henge	1
fixion	fixion	1
christmas settings	christmas settings	1
watson medical algorithm	watson medical algorithm	1
cold medicine	cold medicine	1
time capsule	time capsule	1
lunch	lunch	1
red car	red car	1
kites	kites	1
colds	colds	1
baking soda and vinegar	baking soda and vinegar	1
fire ants	fire ants	1
food combinations	food combinations	1
hoverboard	hoverboard	1
supreme court	supreme court	1
five-day forecast	five-day forecast	1
dna	dna	1
snakes	snakes	1
flashlights	flashlights	1
linguistics club	linguistics club	1
isolation	isolation	1
marketwatch	marketwatch	1
water delivery	water delivery	1
salvage	salvage	1
git	git	1
launch status check	launch status check	1
human subjects	human subjects	1
play-by-play	play-by-play	1
overthinking	overthinking	1
bell 's theorem	bell 's theorem	1
the source	the source	1
frankenstein	frankenstein	1
hardware reductionism	hardware reductionism	1
food rule	food rule	1
keyboard problems	keyboard problems	1
similarities	similarities	1
moments of inspiration	moments of inspiration	1
nasa press conference	nasa press conference	1
picture a grassy field	picture a grassy field	1
birthday	birthday	1
travel ghost	travel ghost	1
tech loops	tech loops	1
squirrelphone	squirrelphone	1
advent	advent	1
i could care less	i could care less	1
footprints	footprints	1
trouble for science	trouble for science	1
cyberintelligence	cyberintelligence	1
xkcd survey	xkcd survey	1
car model names	car model names	1
engineer syllogism	engineer syllogism	1
magic tree	magic tree	1
kitchen tips	kitchen tips	1
board game	board game	1
back seat	back seat	1
synonym movies	synonym movies	1
i in team	i in team	1
water phase diagram	water phase diagram	1
bubblegum	bubblegum	1
driving	driving	1
vet	vet	1
ozymandias	ozymandias	1
the sky	the sky	1
spice girls	spice girls	1
public key	public key	1
rulebook	rulebook	1
episode vii	episode vii	1
solar system questions	solar system questions	1
tamagotchi hive	tamagotchi hive	1
strengths and weaknesses	strengths and weaknesses	1
margaret	margaret	1
team effort	team effort	1
scheduling conflict	scheduling conflict	1
voice	voice	1
hemingway	hemingway	1
planning	planning	1
lyrics	lyrics	1
types	types	1
the martian	the martian	1
words for pets	words for pets	1
beer	beer	1
antique factory	antique factory	1
new horizons	new horizons	1
the bdlpswdks effect	the bdlpswdks effect	1
keyboard mash	keyboard mash	1
bracket	bracket	1
vodka	vodka	1
humans	humans	1
placebo blocker	placebo blocker	1
dimensions	dimensions	1
microdrones	microdrones	1
astronomy	astronomy	1
sword in the stone	sword in the stone	1
degree-off	degree-off	1
venus	venus	1
typical morning routine	typical morning routine	1
spectroscopy	spectroscopy	1
win by induction	win by induction	1
basketball earth	basketball earth	1
permacal	permacal	1
code quality	code quality	1
horoscopes	horoscopes	1
spice girl	spice girl	1
napoleon	napoleon	1
scenery cheat sheet	scenery cheat sheet	1
operating systems	operating systems	1
metaball	metaball	1
xkcloud	xkcloud	1
ontological argument	ontological argument	1
opportunity	opportunity	1
squirrel plan	squirrel plan	1
wasted time	wasted time	1
mysteries	mysteries	1
upside-down map	upside-down map	1
arbitrage	arbitrage	1
terry pratchett	terry pratchett	1
new products	new products	1
art project	art project	1
hard reboot	hard reboot	1
insurance	insurance	1
meeting	meeting	1
dress color	dress color	1
stories of the past and future	stories of the past and future	1
atoms	atoms	1
fundamental forces	fundamental forces	1
flowcharts	flowcharts	1
tornado	tornado	1
vacuum	vacuum	1
friendship	friendship	1
apollo speeches	apollo speeches	1
quotative like	quotative like	1
api	api	1
super bowl	super bowl	1
troubleshooting	troubleshooting	1
p-values	p-values	1
star wars	star wars	1
technically	technically	1
screws	screws	1
location sharing	location sharing	1
geography	geography	1
gut fauna	gut fauna	1
kix	kix	1
uv	uv	1
worrying	worrying	1
email	email	1
phone checking	phone checking	1
santa	santa	1
altitude	altitude	1
blind trials	blind trials	1
payloads	payloads	1
smfw	smfw	1
documents	documents	1
small moon	small moon	1
feedback	feedback	1
on the moon	on the moon	1
trolley problem	trolley problem	1
done	done	1
fmri	fmri	1
jurassic world	jurassic world	1
background screens	background screens	1
ai-box experiment	ai-box experiment	1
red rover	red rover	1
question	question	1
meta-analysis	meta-analysis	1
landing	landing	1
efficiency	efficiency	1
cloud	cloud	1
language nerd	language nerd	1
chemistry	chemistry	1
turnabout	turnabout	1
geese	geese	1
rack unit	rack unit	1
higgs boson	higgs boson	1
orb hammer	orb hammer	1
presidential alert	presidential alert	1
where do birds go	where do birds go	1
lightsaber	lightsaber	1
the sake of argument	the sake of argument	1
marriage	marriage	1
proteins	proteins	1
data	data	1
move fast and break things	move fast and break things	1
ios keyboard	ios keyboard	1
reduce your payments	reduce your payments	1
tasks	tasks	1
en garde	en garde	1
conversation	conversation	1
my phone is dying	my phone is dying	1
future self	future self	1
watches	watches	1
on the phone	on the phone	1
horse	horse	1
pixels	pixels	1
ballooning	ballooning	1
writing skills	writing skills	1
suddenly popular	suddenly popular	1
teenage mutant ninja turtles	teenage mutant ninja turtles	1
loop	loop	1
california	california	1
query	query	1
march of the penguins	march of the penguins	1
worst hurricane	worst hurricane	1
universal converter box	universal converter box	1
meteor	meteor	1
quantum vacuum virtual plasma	quantum vacuum virtual plasma	1
thesis defense	thesis defense	1
harpoons	harpoons	1
new	new	1
d.b. cooper	d.b. cooper	1
chaos	chaos	1
snake facts	snake facts	1
luke	luke	1
actors	actors	1
power cord	power cord	1
superm * n	superm * n	1
timeghost	timeghost	1
dominant players	dominant players	1
darkness	darkness	1
research ethics	research ethics	1
surface area	surface area	1
subduction license	subduction license	1
clumsy foreshadowing	clumsy foreshadowing	1
people are stupid	people are stupid	1
throwing rocks	throwing rocks	1
krypton	krypton	1
magic words	magic words	1
rocket packs	rocket packs	1
margin	margin	1
manual for civilization	manual for civilization	1
turbine	turbine	1
fish	fish	1
jump	jump	1
astronaut vandalism	astronaut vandalism	1
urn	urn	1
screenshot	screenshot	1
smartwatches	smartwatches	1
brightness	brightness	1
president	president	1
tmi	tmi	1
one of the	one of the	1
installing	installing	1
train	train	1
inflation	inflation	1
xkcd phone	xkcd phone	1
morse code	morse code	1
google announcement	google announcement	1
old files	old files	1
phone alarm	phone alarm	1
nro	nro	1
free speech	free speech	1
orbital mechanics	orbital mechanics	1
airplane message	airplane message	1
heartbleed explanation	heartbleed explanation	1
heartbleed	heartbleed	1
cosmologist on a tire swing	cosmologist on a tire swing	1
metamaterials	metamaterials	1
lorenz	lorenz	1
should n't be hard	should n't be hard	1
before the internet	before the internet	1
t distribution	t distribution	1
career	career	1
answers	answers	1
digits	digits	1
manuals	manuals	1
ancient stars	ancient stars	1
types of editors	types of editors	1
unique date	unique date	1
when you assume	when you assume	1
land mammals	land mammals	1
hack	hack	1
transformers	transformers	1
now	now	1
second	second	1
first date	first date	1
slippery slope	slippery slope	1
frequency	frequency	1
standing	standing	1
update	update	1
mobile marketing	mobile marketing	1
sharks	sharks	1
rejection	rejection	1
weather	weather	1
protocol	protocol	1
winter	winter	1
cold	cold	1
automation	automation	1
actually	actually	1
theft	theft	1
inexplicable	inexplicable	1
questions for god	questions for god	1
photos	photos	1
regex golf	regex golf	1
haskell	haskell	1
goldbach conjectures	goldbach conjectures	1
infinite scrolling	infinite scrolling	1
christmas lights	christmas lights	1
buzzfeed christmas	buzzfeed christmas	1
sigil cycle	sigil cycle	1
undocumented feature	undocumented feature	1
glass trolling	glass trolling	1
profile info	profile info	1
year in review	year in review	1
file extensions	file extensions	1
galilean moons	galilean moons	1
i do n't own a tv	i do n't own a tv	1
exoplanet neighborhood	exoplanet neighborhood	1
oort cloud	oort cloud	1
git commit	git commit	1
new study	new study	1
telescope names	telescope names	1
job interview	job interview	1
pi vs. tau	pi vs. tau	1
shoot for the moon	shoot for the moon	1
syllable planning	syllable planning	1
simple answers	simple answers	1
substitutions	substitutions	1
puzzle	puzzle	1
encryptic	encryptic	1
third way	third way	1
improved keyboard	improved keyboard	1
headlines	headlines	1
monty hall	monty hall	1
minifigs	minifigs	1
mystery news	mystery news	1
reverse identity theft	reverse identity theft	1
giraffes	giraffes	1
ayn random	ayn random	1
angular size	angular size	1
int -lrb- pi -rrb-	int -lrb- pi -rrb-	1
open letter	open letter	1
tall infographics	tall infographics	1
shadowfacts	shadowfacts	1
highlighting	highlighting	1
functional	functional	1
privacy opinions	privacy opinions	1
mess	mess	1
halting problem	halting problem	1
juicer	juicer	1
slideshow	slideshow	1
reassuring	reassuring	1
unquote	unquote	1
shake that	shake that	1
ld50	ld50	1
bee orchid	bee orchid	1
first	first	1
monster	monster	1
questions	questions	1
columbus	columbus	1
preferred chat system	preferred chat system	1
exoplanet names	exoplanet names	1
increased risk	increased risk	1
anti-glass	anti-glass	1
old accounts	old accounts	1
meteor showers	meteor showers	1
sphere	sphere	1
the mother of all suspicious files	the mother of all suspicious files	1
pale blue dot	pale blue dot	1
10-day forecast	10-day forecast	1
snare	snare	1
scary names	scary names	1
annoying ringtone champion	annoying ringtone champion	1
quantum mechanics	quantum mechanics	1
social media	social media	1
enlightenment	enlightenment	1
qr code	qr code	1
seashell	seashell	1
settled	settled	1
relativity	relativity	1
realistic criteria	realistic criteria	1
habitable zone	habitable zone	1
polar/cartesian	polar/cartesian	1
screensaver	screensaver	1
prometheus	prometheus	1
the pace of modern life	the pace of modern life	1
balloon internet	balloon internet	1
ice sheets	ice sheets	1
dwarf fortress	dwarf fortress	1
pastime	pastime	1
nomenclature	nomenclature	1
hipsters	hipsters	1
reports	reports	1
doors of durin	doors of durin	1
cells	cells	1
sticks and stones	sticks and stones	1
insight	insight	1
geoguessr	geoguessr	1
combination vision test	combination vision test	1
interstellar memes	interstellar memes	1
birds and dinosaurs	birds and dinosaurs	1
i 'm so random	i 'm so random	1
encoding	encoding	1
footnote labyrinths	footnote labyrinths	1
airaware	airaware	1
einstein	einstein	1
is it worth the time ?	is it worth the time ?	1
detail	detail	1
time machines	time machines	1
girls and boys	girls and boys	1
integration by parts	integration by parts	1
authorization	authorization	1
silence	silence	1
geologist	geologist	1
all adobe updates	all adobe updates	1
subways	subways	1
flowchart	flowchart	1
stratigraphic record	stratigraphic record	1
externalities	externalities	1
humming	humming	1
the past	the past	1
time	time	1
voyager 1	voyager 1	1
bonding	bonding	1
aspect ratio	aspect ratio	1
bumblebees	bumblebees	1
ineffective sorts	ineffective sorts	1
circumference formula	circumference formula	1
rose petals	rose petals	1
rembrandt photo	rembrandt photo	1
pgp	pgp	1
virus venn diagram	virus venn diagram	1
pickup artists	pickup artists	1
time robot	time robot	1
those not present	those not present	1
moving sidewalks	moving sidewalks	1
app	app	1
steroids	steroids	1
workflow	workflow	1
perl problems	perl problems	1
bridge	bridge	1
expedition	expedition	1
tar	tar	1
star trek into darkness	star trek into darkness	1
argument	argument	1
amazon	amazon	1
home alone	home alone	1
debugger	debugger	1
log scale	log scale	1
hand sanitizer	hand sanitizer	1
drop those pounds	drop those pounds	1
countdown	countdown	1
rubber sheet	rubber sheet	1
sick day	sick day	1
conditioning	conditioning	1
kolmogorov directions	kolmogorov directions	1
resolution	resolution	1
proof	proof	1
communion	communion	1
tests	tests	1
instagram	instagram	1
broomstick	broomstick	1
nothing to offer	nothing to offer	1
evolving	evolving	1
honest	honest	1
sky color	sky color	1
tags	tags	1
location	location	1
coverage	coverage	1
two years	two years	1
calendar of meaningful dates	calendar of meaningful dates	1
rubber and glue	rubber and glue	1
heatmap	heatmap	1
ltr	ltr	1
broken mirror	broken mirror	1
arachnoneurology	arachnoneurology	1
logic boat	logic boat	1
frequentists vs. bayesians	frequentists vs. bayesians	1
math	math	1
poll watching	poll watching	1
cell number	cell number	1
congress	congress	1
epsilon and zeta	epsilon and zeta	1
objects in mirror	objects in mirror	1
law of drama	law of drama	1
the universal label	the universal label	1
electoral precedent	electoral precedent	1
identity	identity	1
blurring the line	blurring the line	1
undoing	undoing	1
my sky	my sky	1
traffic lights	traffic lights	1
sky	sky	1
metallurgy	metallurgy	1
killed in action	killed in action	1
think logically	think logically	1
premiere	premiere	1
click and drag	click and drag	1
refrigerator	refrigerator	1
cautionary ghost	cautionary ghost	1
sports cheat sheet	sports cheat sheet	1
add	add	1
license plate	license plate	1
feathers	feathers	1
fastest-growing	fastest-growing	1
sketchiness	sketchiness	1
vows	vows	1
tuesdays	tuesdays	1
star ratings	star ratings	1
a hypochondriac 's nightmare	a hypochondriac 's nightmare	1
clinically studied ingredient	clinically studied ingredient	1
crazy straws	crazy straws	1
interview	interview	1
forget	forget	1
michael phelps	michael phelps	1
curiosity	curiosity	1
formal languages	formal languages	1
internal monologue	internal monologue	1
cirith ungol	cirith ungol	1
eyelash wish log	eyelash wish log	1
contextbot	contextbot	1
server problem	server problem	1
writing styles	writing styles	1
geology	geology	1
argument victory	argument victory	1
visual field	visual field	1
united shapes	united shapes	1
knights	knights	1
home organization	home organization	1
groundhog day	groundhog day	1
warning	warning	1
moon landing	moon landing	1
weekend	weekend	1
seventies	seventies	1
exoplanets	exoplanets	1
words for small sets	words for small sets	1
alphabet	alphabet	1
swiftkey	swiftkey	1
pressures	pressures	1
laundry	laundry	1
shoes	shoes	1
front door	front door	1
kill hitler	kill hitler	1
budget news	budget news	1
est	est	1
crowdsourcing	crowdsourcing	1
old-timers	old-timers	1
klout	klout	1
felidae	felidae	1
kickstarter	kickstarter	1
the bacon	the bacon	1
every major 's terrible	every major 's terrible	1
visited	visited	1
forgot algebra	forgot algebra	1
bookshelf	bookshelf	1
emotion	emotion	1
approximations	approximations	1
skynet	skynet	1
constraints	constraints	1
romney quiz	romney quiz	1
ablogalypse	ablogalypse	1
never	never	1
whites of their eyes	whites of their eyes	1
lakes and oceans	lakes and oceans	1
rubisco	rubisco	1
fountain	fountain	1
umwelt	umwelt	1
reviews	reviews	1
cadbury eggs	cadbury eggs	1
share buttons	share buttons	1
formal logic	formal logic	1
networking	networking	1
s/keyboard/leopard /	s/keyboard/leopard /	1
keyed	keyed	1
drawing stars	drawing stars	1
communication	communication	1
pickup artist	pickup artist	1
compare and contrast	compare and contrast	1
tumblr	tumblr	1
error code	error code	1
late-night pbs	late-night pbs	1
so it has come to this	so it has come to this	1
business plan	business plan	1
orion nebula	orion nebula	1
first post	first post	1
good cop , dadaist cop	good cop , dadaist cop	1
backward in time	backward in time	1
valentine dilemma	valentine dilemma	1
kerning	kerning	1
car problems	car problems	1
wake up sheeple	wake up sheeple	1
wrong superhero	wrong superhero	1
baby names	baby names	1
etymology-man	etymology-man	1
sigh	sigh	1
suckville	suckville	1
sustainable	sustainable	1
sloppier than fiction	sloppier than fiction	1
sopa	sopa	1
batman	batman	1
adam and eve	adam and eve	1
game ais	game ais	1
aaaaaa	aaaaaa	1
cougars	cougars	1
wait wait	wait wait	1
making things difficult	making things difficult	1
advent calendar	advent calendar	1
brand identity	brand identity	1
mnemonics	mnemonics	1
phantom menace	phantom menace	1
plastic bags	plastic bags	1
cryogenics	cryogenics	1
tradition	tradition	1
potential	potential	1
drinking fountains	drinking fountains	1
percentage points	percentage points	1
space launch system	space launch system	1
privacy	privacy	1
set theory	set theory	1
porn folder	porn folder	1
money	money	1
wisdom of the ancients	wisdom of the ancients	1
citogenesis	citogenesis	1
map projections	map projections	1
sail	sail	1
occulting telescope	occulting telescope	1
the general problem	the general problem	1
mtv generation	mtv generation	1
november	november	1
alternative literature	alternative literature	1
the important field	the important field	1
delta-p	delta-p	1
everything	everything	1
prairie	prairie	1
jet fuel	jet fuel	1
elements	elements	1
dorm poster	dorm poster	1
x11	x11	1
the corliss resolution	the corliss resolution	1
eternal flame	eternal flame	1
subliminal	subliminal	1
caroling	caroling	1
hotels	hotels	1
development	development	1
sharing	sharing	1
neutrinos	neutrinos	1
chin-up bar	chin-up bar	1
stud finder	stud finder	1
working	working	1
mystery solved	mystery solved	1
file transfer	file transfer	1
ai	ai	1
investing	investing	1
family decals	family decals	1
i 'm sorry	i 'm sorry	1
hurricane names	hurricane names	1
empirical	empirical	1
juggling	juggling	1
depth perception	depth perception	1
oversight	oversight	1
arrow	arrow	1
t-cells	t-cells	1
tornadoguard	tornadoguard	1
password strength	password strength	1
missed connections	missed connections	1
mac/pc	mac/pc	1
tattoo	tattoo	1
cia	cia	1
lanes	lanes	1
days of the week	days of the week	1
speculation	speculation	1
mimic octopus	mimic octopus	1
standards	standards	1
time vulture	time vulture	1
cell phones	cell phones	1
strunk and white	strunk and white	1
fight club	fight club	1
delivery notification	delivery notification	1
youtube parties	youtube parties	1
tween bromance	tween bromance	1
google +	google +	1
hofstadter	hofstadter	1
unpickable	unpickable	1
connoisseur	connoisseur	1
ice	ice	1
core	core	1
manual override	manual override	1
magic school bus	magic school bus	1
permanence	permanence	1
worst-case shopping	worst-case shopping	1
the cloud	the cloud	1
ages	ages	1
advertising discovery	advertising discovery	1
homeownership	homeownership	1
sports	sports	1
extended mind	extended mind	1
darmok and jalad	darmok and jalad	1
temperature	temperature	1
religions	religions	1
number line	number line	1
chain of command	chain of command	1
elevator inspection	elevator inspection	1
marie curie	marie curie	1
teaching physics	teaching physics	1
progeny	progeny	1
null hypothesis	null hypothesis	1
movie ages	movie ages	1
etymology	etymology	1
turtles	turtles	1
heaven	heaven	1
future timeline	future timeline	1
craigslist apartments	craigslist apartments	1
recycling	recycling	1
rogers st.	rogers st.	1
pain rating	pain rating	1
significant	significant	1
probability	probability	1
headache	headache	1
lamp	lamp	1
model rail	model rail	1
beauty	beauty	1
trapped	trapped	1
time management	time management	1
fps mod	fps mod	1
fairy tales	fairy tales	1
charity	charity	1
advertising	advertising	1
server attention span	server attention span	1
nolan chart	nolan chart	1
herpetology	herpetology	1
compass and straightedge	compass and straightedge	1
nanobots	nanobots	1
flying cars	flying cars	1
let go	let go	1
wisdom teeth	wisdom teeth	1
never do this	never do this	1
-lrb-	-lrb-	1
milk	milk	1
archimedes	archimedes	1
trochee fixation	trochee fixation	1
learning to cook	learning to cook	1
consecutive vowels	consecutive vowels	1
local g	local g	1
na	na	1
world according to americans	world according to americans	1
complex conjugate	complex conjugate	1
stingray nebula	stingray nebula	1
dental nerve	dental nerve	1
modern history	modern history	1
good code	good code	1
misconceptions	misconceptions	1
mark	mark	1
audiophiles	audiophiles	1
serious	serious	1
explorers	explorers	1
incident	incident	1
coupon code	coupon code	1
sickness	sickness	1
tree	tree	1
wikileaks	wikileaks	1
convincing	convincing	1
tic-tac-toe	tic-tac-toe	1
weather radar	weather radar	1
genetic analysis	genetic analysis	1
arsenic-based life	arsenic-based life	1
positive attitude	positive attitude	1
my business idea	my business idea	1
guest week : zach weiner -lrb- smbc -rrb-	guest week : zach weiner -lrb- smbc -rrb-	1
guest week : jeffrey rowland -lrb- overcompensating -rrb-	guest week : jeffrey rowland -lrb- overcompensating -rrb-	1
guest week : bill amend -lrb- foxtrot -rrb-	guest week : bill amend -lrb- foxtrot -rrb-	1
guest week : david troupes -lrb- buttercup festival -rrb-	guest week : david troupes -lrb- buttercup festival -rrb-	1
guest week : jeph jacques -lrb- questionable content -rrb-	guest week : jeph jacques -lrb- questionable content -rrb-	1
five-minute comics : part 1	five-minute comics : part 1	1
illness	illness	1
mutual	mutual	1
applied math	applied math	1
mu	mu	1
diode	diode	1
one-liners	one-liners	1
glass	glass	1
starlight	starlight	1
constructive	constructive	1
the economic argument	the economic argument	1
connected	connected	1
tech support	tech support	1
paradise city	paradise city	1
pumpkin carving	pumpkin carving	1
airfoil	airfoil	1
golden hammer	golden hammer	1
beautiful dream	beautiful dream	1
stephen hawking	stephen hawking	1
adjectives	adjectives	1
debian-main	debian-main	1
bad ex	bad ex	1
conditional risk	conditional risk	1
inside joke	inside joke	1
physicists	physicists	1
password reuse	password reuse	1
leaving	leaving	1
control	control	1
showdown	showdown	1
the carriage	the carriage	1
orbiter	orbiter	1
exoplanets	exoplanets	1
open mic night	open mic night	1
falling asleep	falling asleep	1
i do n't want directions	i do n't want directions	1
desecration	desecration	1
ahead stop	ahead stop	1
sample	sample	1
anxiety	anxiety	1
scheduling	scheduling	1
pore strips	pore strips	1
still no sleep	still no sleep	1
atheists	atheists	1
university website	university website	1
frogger	frogger	1
period speech	period speech	1
all the girls	all the girls	1
war	war	1
temper	temper	1
green flash	green flash	1
dilution	dilution	1
workaround	workaround	1
analogies	analogies	1
dfs	dfs	1
moria	moria	1
raptor fences	raptor fences	1
toot	toot	1
public opinion	public opinion	1
interdisciplinary	interdisciplinary	1
dependencies	dependencies	1
southern half	southern half	1
phobia	phobia	1
swimsuit issue	swimsuit issue	1
book burning	book burning	1
study	study	1
worst-case scenario	worst-case scenario	1
geeks and nerds	geeks and nerds	1
birth	birth	1
dyslexics	dyslexics	1
walkthrough	walkthrough	1
infrastructures	infrastructures	1
campfire	campfire	1
blogging	blogging	1
the tell-tale beat	the tell-tale beat	1
malamanteau	malamanteau	1
incision	incision	1
yogurt	yogurt	1
cemetery	cemetery	1
floor	floor	1
outbreak	outbreak	1
eagle	eagle	1
hdtv	hdtv	1
desert island	desert island	1
circuit diagram	circuit diagram	1
laser pointer	laser pointer	1
ipad	ipad	1
trade expert	trade expert	1
seat selection	seat selection	1
literally	literally	1
hell	hell	1
seismic waves	seismic waves	1
computer problems	computer problems	1
flatland	flatland	1
recipes	recipes	1
brain worms	brain worms	1
the flake equation	the flake equation	1
furtive	furtive	1
time machine	time machine	1
numbers	numbers	1
porn for women	porn for women	1
geoip	geoip	1
single ladies	single ladies	1
seismograph	seismograph	1
collatz conjecture	collatz conjecture	1
i am	i am	1
sex dice	sex dice	1
joshing	joshing	1
freedom	freedom	1
devotion to duty	devotion to duty	1
principle of explosion	principle of explosion	1
honor societies	honor societies	1
snow tracking	snow tracking	1
science valentine	science valentine	1
complexion	complexion	1
trimester	trimester	1
you hang up first	you hang up first	1
tensile vs. shear strength	tensile vs. shear strength	1
strip games	strip games	1
spirit	spirit	1
retro virus	retro virus	1
children 's fantasy	children 's fantasy	1
dirty harry	dirty harry	1
microsd	microsd	1
semicontrolled demolition	semicontrolled demolition	1
first design	first design	1
self-description	self-description	1
dimensional analysis	dimensional analysis	1
admin mourning	admin mourning	1
g-spot	g-spot	1
we get it	we get it	1
science montage	science montage	1
force	force	1
gravity wells	gravity wells	1
christmas plans	christmas plans	1
researcher translation	researcher translation	1
asshole	asshole	1
abstraction	abstraction	1
revolutionary	revolutionary	1
natural parenting	natural parenting	1
the sun	the sun	1
suggestions	suggestions	1
stephen and me	stephen and me	1
spinal tap amps	spinal tap amps	1
experiment	experiment	1
pandora	pandora	1
skifree	skifree	1
silent hammer	silent hammer	1
prudence	prudence	1
academia vs. business	academia vs. business	1
sagan-man	sagan-man	1
iphone or droid	iphone or droid	1
two-party system	two-party system	1
sympathy	sympathy	1
lego	lego	1
orbitals	orbitals	1
movie narrative charts	movie narrative charts	1
climbing	climbing	1
nachos	nachos	1
so bad it 's worse	so bad it 's worse	1
more accurate	more accurate	1
bag check	bag check	1
nowhere	nowhere	1
static	static	1
fall foliage	fall foliage	1
scary	scary	1
conversations	conversations	1
rps	rps	1
surgery	surgery	1
ohm	ohm	1
creepy	creepy	1
free	free	1
tornado hunter	tornado hunter	1
lincoln-douglas	lincoln-douglas	1
the search	the search	1
scribblenauts	scribblenauts	1
brontosaurus	brontosaurus	1
locke and demosthenes	locke and demosthenes	1
date	date	1
blockbuster mining	blockbuster mining	1
suspicion	suspicion	1
anatomy text	anatomy text	1
time travel	time travel	1
skins	skins	1
psychic	psychic	1
tech support cheat sheet	tech support cheat sheet	1
newton and leibniz	newton and leibniz	1
collections	collections	1
branding	branding	1
haiku proof	haiku proof	1
superlative	superlative	1
wings	wings	1
supported features	supported features	1
asteroid	asteroid	1
understocked	understocked	1
lease	lease	1
avoidance	avoidance	1
woodpecker	woodpecker	1
threesome	threesome	1
estimation	estimation	1
disaster voyeurism	disaster voyeurism	1
sheeple	sheeple	1
tab explosion	tab explosion	1
form	form	1
cutting edge	cutting edge	1
extrapolating	extrapolating	1
qwertial aphasia	qwertial aphasia	1
idiocracy	idiocracy	1
overstimulated	overstimulated	1
game theory	game theory	1
android boyfriend	android boyfriend	1
apocalypse	apocalypse	1
porn	porn	1
addiction	addiction	1
latitude	latitude	1
android girlfriend	android girlfriend	1
period	period	1
voynich manuscript	voynich manuscript	1
drama	drama	1
troll slayer	troll slayer	1
papyrus	papyrus	1
designated drivers	designated drivers	1
pep rally	pep rally	1
crime scene	crime scene	1
mission to culture	mission to culture	1
outreach	outreach	1
unsatisfied	unsatisfied	1
cnr	cnr	1
brakes	brakes	1
the race : part 1	the race : part 1	1
packages	packages	1
tag combination	tag combination	1
swine flu	swine flu	1
parental trolling	parental trolling	1
together	together	1
ca n't sleep	ca n't sleep	1
new car	new car	1
borders	borders	1
urgent mission	urgent mission	1
matrix revisited	matrix revisited	1
security question	security question	1
crossbows	crossbows	1
fermirotica	fermirotica	1
parking	parking	1
well	well	1
lithium batteries	lithium batteries	1
no pun intended	no pun intended	1
students	students	1
alternative energy revolution	alternative energy revolution	1
two mirrors	two mirrors	1
not enough work	not enough work	1
pirate bay	pirate bay	1
correlation	correlation	1
etch-a-sketch	etch-a-sketch	1
density	density	1
westley 's a dick	westley 's a dick	1
kindle	kindle	1
simple	simple	1
music drm	music drm	1
neutrality schmeutrality	neutrality schmeutrality	1
pep talk	pep talk	1
sierpinski valentine	sierpinski valentine	1
cover-up	cover-up	1
ted talk	ted talk	1
base system	base system	1
boyfriend	boyfriend	1
security	security	1
ducklings	ducklings	1
space elevators	space elevators	1
it might be cool	it might be cool	1
genetic algorithms	genetic algorithms	1
laptop hell	laptop hell	1
piano	piano	1
contingency plan	contingency plan	1
i 'm an idiot	i 'm an idiot	1
sledding discussion	sledding discussion	1
keynote	keynote	1
converting to metric	converting to metric	1
i know you 're listening	i know you 're listening	1
party	party	1
decline	decline	1
google trends	google trends	1
cuttlefish	cuttlefish	1
11 th grade	11 th grade	1
flow charts	flow charts	1
marshmallow gun	marshmallow gun	1
wood chips	wood chips	1
no one must know	no one must know	1
simultaneous	simultaneous	1
friends	friends	1
alternate currency	alternate currency	1
sleet	sleet	1
egg drop failure	egg drop failure	1
induced current	induced current	1
drapes	drapes	1
experimentation	experimentation	1
a bunch of rocks	a bunch of rocks	1
legal hacks	legal hacks	1
terminology	terminology	1
dark flow	dark flow	1
election	election	1
scantron	scantron	1
secretary : part 1	secretary : part 1	1
actuarial	actuarial	1
scrabble	scrabble	1
twitter	twitter	1
morning routine	morning routine	1
going west	going west	1
steal this comic	steal this comic	1
numerical sex positions	numerical sex positions	1
i am not a ninja	i am not a ninja	1
depth	depth	1
flash games	flash games	1
fiction rule of thumb	fiction rule of thumb	1
height	height	1
listen to yourself	listen to yourself	1
spore	spore	1
tones	tones	1
the staple madness	the staple madness	1
typewriter	typewriter	1
one-sided	one-sided	1
further boomerang difficulties	further boomerang difficulties	1
turn-on	turn-on	1
still raw	still raw	1
house of pancakes	house of pancakes	1
aversion fads	aversion fads	1
the end is not for a while	the end is not for a while	1
improvised	improvised	1
fetishes	fetishes	1
x girls y cups	x girls y cups	1
moving	moving	1
quantum teleportation	quantum teleportation	1
rba	rba	1
voting machines	voting machines	1
freemanic paracusia	freemanic paracusia	1
paleontology	paleontology	1
holy ghost	holy ghost	1
regrets	regrets	1
frustration	frustration	1
cautionary	cautionary	1
hats	hats	1
rewiring	rewiring	1
upcoming hurricanes	upcoming hurricanes	1
mission	mission	1
impostor	impostor	1
the sea	the sea	1
things fall apart	things fall apart	1
good morning	good morning	1
too old for this shit	too old for this shit	1
in popular culture	in popular culture	1
i am not good with boomerangs	i am not good with boomerangs	1
macgyver gets lazy	macgyver gets lazy	1
know your vines	know your vines	1
xkcd loves the discovery channel	xkcd loves the discovery channel	1
babies	babies	1
road rage	road rage	1
thinking ahead	thinking ahead	1
internet argument	internet argument	1
suv	suv	1
how it happened	how it happened	1
purity	purity	1
xkcd goes to the airport	xkcd goes to the airport	1
delivery	delivery	1
every damn morning	every damn morning	1
fantasy	fantasy	1
starwatching	starwatching	1
bad timing	bad timing	1
geohashing	geohashing	1
fortune cookies	fortune cookies	1
security holes	security holes	1
finish line	finish line	1
a better idea	a better idea	1
making hash browns	making hash browns	1
jealousy	jealousy	1
forks and spoons	forks and spoons	1
stove ownership	stove ownership	1
the man who fell sideways	the man who fell sideways	1
zealous autoconfig	zealous autoconfig	1
restraining order	restraining order	1
mistranslations	mistranslations	1
new pet	new pet	1
startled	startled	1
techno	techno	1
math paper	math paper	1
electric skateboard -lrb- double comic -rrb-	electric skateboard -lrb- double comic -rrb-	1
overqualified	overqualified	1
cheap gps	cheap gps	1
venting	venting	1
convincing pickup line	convincing pickup line	1
large hadron collider	large hadron collider	1
important life lesson	important life lesson	1
travelling salesman problem	travelling salesman problem	1
tap that ass	tap that ass	1
unscientific	unscientific	1
the ring	the ring	1
morning	morning	1
kilobyte	kilobyte	1
ultimate game	ultimate game	1
making rules	making rules	1
anti-mindvirus	anti-mindvirus	1
nightmares	nightmares	1
keeping time	keeping time	1
fuck grapefruit	fuck grapefruit	1
advanced technology	advanced technology	1
duty calls	duty calls	1
how it works	how it works	1
the drake equation	the drake equation	1
helping	helping	1
trebuchet	trebuchet	1
mobius battle	mobius battle	1
emoticon	emoticon	1
forgetting	forgetting	1
real programmers	real programmers	1
bug	bug	1
pod bay doors	pod bay doors	1
journal	journal	1
the data so far	the data so far	1
to be wanted	to be wanted	1
compiler complaint	compiler complaint	1
redwall	redwall	1
dangers	dangers	1
bass	bass	1
fandom	fandom	1
your mom	your mom	1
slides	slides	1
responsible behavior	responsible behavior	1
reset	reset	1
blade runner	blade runner	1
christmas back home	christmas back home	1
writers strike	writers strike	1
rock band	rock band	1
loud party	loud party	1
flies	flies	1
nerd sniping	nerd sniping	1
couple	couple	1
startling	startling	1
python	python	1
far away	far away	1
trolling	trolling	1
network	network	1
success	success	1
close to you	close to you	1
brick archway	brick archway	1
diet coke + mentos	diet coke + mentos	1
fight	fight	1
classic	classic	1
future	future	1
post office showdown	post office showdown	1
priorities	priorities	1
mattress	mattress	1
wasteland	wasteland	1
getting out of hand	getting out of hand	1
gyroscopes	gyroscopes	1
photoshops	photoshops	1
indecision	indecision	1
turing test	turing test	1
eggs	eggs	1
exploits of a mom	exploits of a mom	1
effect an effect	effect an effect	1
a-minus-minus	a-minus-minus	1
tapping	tapping	1
ballmer peak	ballmer peak	1
pix plz	pix plz	1
thighs	thighs	1
28-hour day	28-hour day	1
engineering hubris	engineering hubris	1
nostalgia	nostalgia	1
that lovin ' feelin '	that lovin ' feelin '	1
loud sex	loud sex	1
braille	braille	1
dating pools	dating pools	1
insomnia	insomnia	1
with apologies to robert frost	with apologies to robert frost	1
action movies	action movies	1
commitment	commitment	1
shopping teams	shopping teams	1
interesting life	interesting life	1
excessive quotation	excessive quotation	1
orphaned projects	orphaned projects	1
nighttime stories	nighttime stories	1
compiling	compiling	1
names	names	1
facebook	facebook	1
aeris dies	aeris dies	1
tesla coil	tesla coil	1
lisp cycles	lisp cycles	1
tony hawk	tony hawk	1
dne	dne	1
bookstore	bookstore	1
rtfm	rtfm	1
goto	goto	1
dignified	dignified	1
fucking blue shells	fucking blue shells	1
alone	alone	1
elevator	elevator	1
np-complete	np-complete	1
all your base	all your base	1
wikipedian protester	wikipedian protester	1
tape measure	tape measure	1
projection	projection	1
organic fuel	organic fuel	1
online package tracking	online package tracking	1
librarians	librarians	1
pickup lines	pickup lines	1
black hat support	black hat support	1
long light	long light	1
fixed width	fixed width	1
thoughts	thoughts	1
with apologies to the who	with apologies to the who	1
electromagnetic spectrum	electromagnetic spectrum	1
linux user at best buy	linux user at best buy	1
powers of one	powers of one	1
merlin	merlin	1
tcmp	tcmp	1
choices : part 1	choices : part 1	1
certainty	certainty	1
in ur reality	in ur reality	1
regarding mussolini	regarding mussolini	1
the glass necklace	the glass necklace	1
clichéd exchanges	clichéd exchanges	1
conspiracy theories	conspiracy theories	1
code talkers	code talkers	1
online communities	online communities	1
subjectivity	subjectivity	1
comic fragment	comic fragment	1
highway engineer pranks	highway engineer pranks	1
escalators	escalators	1
cd tray fight	cd tray fight	1
snopes	snopes	1
chess photo	chess photo	1
hypotheticals	hypotheticals	1
factoring the time	factoring the time	1
labyrinth puzzle	labyrinth puzzle	1
floor tiles	floor tiles	1
tabletop roleplaying	tabletop roleplaying	1
appropriate term	appropriate term	1
the difference	the difference	1
battle room	battle room	1
dream girl	dream girl	1
blagofaire	blagofaire	1
keyboards are disgusting	keyboards are disgusting	1
collecting double-takes	collecting double-takes	1
kite	kite	1
escape artist	escape artist	1
a new captcha approach	a new captcha approach	1
chess enlightenment	chess enlightenment	1
cat proximity	cat proximity	1
hamiltonian	hamiltonian	1
graffiti	graffiti	1
resonance	resonance	1
color codes	color codes	1
swingset	swingset	1
open source	open source	1
lisp	lisp	1
valentine 's day	valentine 's day	1
small talk	small talk	1
random number	random number	1
philosophy	philosophy	1
blanket fort	blanket fort	1
nintendo surgeon	nintendo surgeon	1
e to the pi minus pi	e to the pi minus pi	1
romantic drama equation	romantic drama equation	1
letting go	letting go	1
the problem with wikipedia	the problem with wikipedia	1
ghostbusters marathon	ghostbusters marathon	1
brain	brain	1
hamster ball heist	hamster ball heist	1
kayak	kayak	1
regular expressions	regular expressions	1
what xkcd means	what xkcd means	1
reno rhymes	reno rhymes	1
candy button paper	candy button paper	1
hallucinations	hallucinations	1
youtube	youtube	1
christmas gps	christmas gps	1
bill nye	bill nye	1
right-hand rule	right-hand rule	1
perspective	perspective	1
ninja turtles	ninja turtles	1
command line fu	command line fu	1
map of the internet	map of the internet	1
penises	penises	1
the perfect sound	the perfect sound	1
working for google	working for google	1
lojban	lojban	1
ipod	ipod	1
exercise	exercise	1
reload	reload	1
the familiar	the familiar	1
console lines	console lines	1
wikifriends	wikifriends	1
matrix transform	matrix transform	1
snacktime rules	snacktime rules	1
nash	nash	1
interblag	interblag	1
canada	canada	1
e to the pi times i	e to the pi times i	1
not really into pokemon	not really into pokemon	1
alice and bob	alice and bob	1
before sunrise	before sunrise	1
automatic doors	automatic doors	1
that 's what she said	that 's what she said	1
movie seating	movie seating	1
skateboarding is not a crime	skateboarding is not a crime	1
string theory	string theory	1
turn back	turn back	1
words that end in gry	words that end in gry	1
reverse euphemisms	reverse euphemisms	1
nihilism	nihilism	1
misusing slang	misusing slang	1
turn signals	turn signals	1
playing devil 's advocate to win	playing devil 's advocate to win	1
donald knuth	donald knuth	1
angular momentum	angular momentum	1
accident	accident	1
penny arcade parody	penny arcade parody	1
boombox	boombox	1
filler art	filler art	1
commented	commented	1
search history	search history	1
beliefs	beliefs	1
cryptography	cryptography	1
hamster ball	hamster ball	1
mario	mario	1
grownups	grownups	1
sandwich	sandwich	1
mispronouncing	mispronouncing	1
a way so familiar	a way so familiar	1
join myspace	join myspace	1
parody week : dinosaur comics	parody week : dinosaur comics	1
parody week : a softer world	parody week : a softer world	1
parody week : tfd and natalie dee	parody week : tfd and natalie dee	1
parody week : megatokyo	parody week : megatokyo	1
parody week : achewood	parody week : achewood	1
delicious	delicious	1
i have owned two electric skateboards	i have owned two electric skateboards	1
pointers	pointers	1
dreams	dreams	1
science fair	science fair	1
substitute	substitute	1
myspace	myspace	1
the raven	the raven	1
music knowledge	music knowledge	1
fans	fans	1
julia stiles	julia stiles	1
content protection	content protection	1
dpain over dt	dpain over dt	1
the fast and the furious	the fast and the furious	1
red spiders cometh	red spiders cometh	1
marketing interview	marketing interview	1
blogofractal	blogofractal	1
centrifugal force	centrifugal force	1
quirky girls	quirky girls	1
balloon	balloon	1
dating service	dating service	1
worst band name ever	worst band name ever	1
pong	pong	1
city	city	1
meerkat	meerkat	1
computational linguists	computational linguists	1
riemann-zeta	riemann-zeta	1
baring my heart	baring my heart	1
clark gable	clark gable	1
spoiler alert	spoiler alert	1
m.c. hammer slide	m.c. hammer slide	1
wright brothers	wright brothers	1
find you	find you	1
moral relativity	moral relativity	1
back to the future	back to the future	1
laser scope	laser scope	1
family circus	family circus	1
binary heart	binary heart	1
fall apart	fall apart	1
a simple plan	a simple plan	1
mail	mail	1
the sierpinski penis game	the sierpinski penis game	1
profile creation flowchart	profile creation flowchart	1
jeremy irons	jeremy irons	1
sunrise	sunrise	1
pwned	pwned	1
jacket	jacket	1
gravitational mass	gravitational mass	1
escher bracelet	escher bracelet	1
velociraptors	velociraptors	1
digital rights management	digital rights management	1
paths	paths	1
national language	national language	1
katamari	katamari	1
frame	frame	1
attention , shopper	attention , shopper	1
my other car	my other car	1
iambic pentameter	iambic pentameter	1
garfield	garfield	1
bored with the internet	bored with the internet	1
familiar	familiar	1
curse levels	curse levels	1
su doku	su doku	1
zeppelin	zeppelin	1
classhole	classhole	1
in the trees	in the trees	1
guitar hero	guitar hero	1
pillow talk	pillow talk	1
nerd girls	nerd girls	1
abusive astronomy	abusive astronomy	1
banter	banter	1
valentine - heart	valentine - heart	1
valentine - karnaugh	valentine - karnaugh	1
stacey 's dad	stacey 's dad	1
super bowl	super bowl	1
graduation	graduation	1
why do you love me ?	why do you love me ?	1
wait for me	wait for me	1
the cure	the cure	1
useless	useless	1
science	science	1
hobby	hobby	1
secret worlds	secret worlds	1
malaria	malaria	1
penny arcade	penny arcade	1
want	want	1
found	found	1
counter-red spiders	counter-red spiders	1
secrets	secrets	1
schrodinger	schrodinger	1
love	love	1
geico	geico	1
old drawing	old drawing	1
light	light	1
bowl	bowl	1
hyphen	hyphen	1
scientists	scientists	1
sheep	sheep	1
flowers	flowers	1
self-reference	self-reference	1
pillar	pillar	1
donner	donner	1
hitler	hitler	1
elefino	elefino	1
meat cereals	meat cereals	1
fourier	fourier	1
godel , escher , kurt halsey	godel , escher , kurt halsey	1
t-shirts	t-shirts	1
kepler	kepler	1
ferret	ferret	1
george clinton	george clinton	1
snapple	snapple	1
what if	what if	1
monty python -- enough	monty python -- enough	1
just alerting you	just alerting you	1
copyright	copyright	1
canyon	canyon	1
poisson	poisson	1
pi equals	pi equals	1
serenity is coming out tomorrow	serenity is coming out tomorrow	1
red spiders	red spiders	1
irony	irony	1
blown apart	blown apart	1
landscape -lrb- sketch -rrb-	landscape -lrb- sketch -rrb-	1
island -lrb- sketch -rrb-	island -lrb- sketch -rrb-	1
petit trees -lrb- sketch -rrb-	petit trees -lrb- sketch -rrb-	1
barrel - part 1	barrel - part 1	1
