Put the chocolate and butter in a metal or glass bowl over barely simmering water. Stir occasionally until melted. Remove from the heat.	put the chocolate and butter in a metal or glass bowl over barely simmering water . stir occasionally until melted . remove from the heat .	1
Pour cake mix into a large bowl. Make a well in the center and pour in milk, eggs, and vegetable oil; stir until well combined. Pour boiling water into the batter and stir to mix.	pour cake mix into a large bowl . make a well in the center and pour in milk , eggs , and vegetable oil ; stir until well combined . pour boiling water into the batter and stir to mix .	1
Pour batter into a slow cooker.	pour batter into a slow cooker .	1
Combine avocados, almond milk, honey, cocoa powder, and vanilla extract in a food processor; blend until the consistency of pudding. Pour over the batter in the slow cooker. Sprinkle chocolate chips on top.	combine avocados , almond milk , honey , cocoa powder , and vanilla extract in a food processor ; blend until the consistency of pudding . pour over the batter in the slow cooker . sprinkle chocolate chips o n top .	1
Cook on High until edges have pulled away from the sides of the cooker, about 2 1/2 hours.	cook on high until edges have pulled away from the sides of the cooker , about 2Â 1/2 hours .	1
In a large bowl, mix together the cake and pudding mixes, sour cream, oil, beaten eggs and water.  Stir in the chocolate chips and pour batter into a well greased 12 cup bundt pan.	in a large bowl , mix together the cake and pudding mixes , sour cream , oil , beaten eggs and water . stir in the chocolate chips and pour batter into a well greased 12 cup bundt pan .	1
In large bowl combine flour, sugar, cocoa,  baking soda, baking powder and salt. Make a well in the center.	in large bowl combine flour , sugar , cocoa , baking soda , baking powder and salt . make a well in the center .	1
Combine the flour, sugar, baking soda and salt.  Beat in the sour cream and eggs.  Set aside.  Melt the butter on low in a saucepan, add the water and 5 tablespoons cocoa.  Bring mixture to a boil then remove from heat.  Allow to cool slightly, then stir cocoa mixture into the egg mixture, mixing until blended.	combine the flour , sugar , baking soda and salt . beat in the sour cream and eggs . set aside . melt the butter on low in a saucepan , add the water and 5 tablespoons cocoa . bring mixture to a boil the n remove from heat . allow to cool slightly , then stir cocoa mixture into the egg mixture , mixing until blended .	1
For the icing:  In a large saucepan, combine the milk, 5 tablespoons cocoa and 1/2 cup butter.  Bring to a boil, then remove from heat.  Stir in the confectioners' sugar and vanilla, then fold in the nuts, mixing until blended.  Spread frosting over warm cake.	for the icing : in a large saucepan , combine the milk , 5 tablespoons cocoa and 1/2 cup butter . bring to a boil , then remove from heat . stir in the confectioners ' sugar and vanilla , then fold in the nuts , mixing until blended . spread frosting over warm cake .	1
Prepare the cake mix according to package directions. Divide two thirds of batter between 2 pans. Stir instant coffee into remaining batter; pour into remaining pan.	prepare the cake mix according to package directions . divide two thirds of batter between 2 pans . stir instant coffee into remaining batter ; pour into remaining pan .	1
To make the filling:  In a small bowl, using an electric mixer set on low speed, combine mascarpone, 1/2 cup confectioners' sugar and 2 tablespoons coffee liqueur; beat just until smooth. Cover with plastic wrap and refrigerate.	to make the filling : in a small bowl , using an electric mixer set on low speed , combine mascarpone , 1/2 cup confectioners ' sugar and 2 tablespoons coffee liqueur ; beat just until smooth . cover with p lastic wrap and refrigerate .	1
To make the frosting:  In a medium bowl, using an electric mixer set on medium-high speed, beat the cream, 1/4 cup confectioners' sugar and 2 tablespoons coffee liqueur until stiff. Fold 1/2 cup of cream mixture into filling mixture.	to make the frosting : in a medium bowl , using an electric mixer set on medium-high speed , beat the cream , 1/4 cup confectioners ' sugar and 2 tablespoons coffee liqueur until stiff . fold 1/2 cup of cr eam mixture into filling mixture .	1
To make the chocolate curls, use a vegetable peeler and run it down the edge of the chocolate bar.	to make the chocolate curls , use a vegetable peeler and run it down the edge of the chocolate bar .	1
To make the frosting, use the second set of ingredients. Cream butter until light and fluffy. Stir in the cocoa and confectioners' sugar alternately with the milk and vanilla. Beat to a spreading consistency.	to make the frosting , use the second set of ingredients . cream butter until light and fluffy . stir in the cocoa and confectioners ' sugar alternately with the milk and vanilla . beat to a spreading cons istency .	1
Split the layers of cooled cake horizontally, cover the top of each layer with frosting, then stack them onto a serving plate. Frost the outside of the cake.	split the layers of cooled cake horizontally , cover the top of each layer with frosting , then stack them onto a serving plate . frost the outside of the cake .	1
In a large bowl, cream butter and sugar together until light and fluffy. Beat in eggs one at time, then stir in vanilla. Add the flour mixture alternately with the cocoa mixture. Spread batter evenly between the 3 prepared pans.	in a large bowl , cream butter and sugar together until light and fluffy . beat in eggs one at time , then stir in vanilla . add the flour mixture alternately with the cocoa mixture . spread batter evenly between the 3 prepared pans .	1
Sift together the flour, sugar, cocoa powder, baking soda, baking powder and salt. Set aside. In a large bowl, whisk together the eggs, oil, coffee and vanilla.  Stir in the sour milk.  Gradually beat in the flour mixture, mixing just until incorporated.	sift together the flour , sugar , cocoa powder , baking soda , baking powder and salt . set aside . in a large bowl , whisk together the eggs , oil , coffee and vanilla . stir in the sour milk . gradually beat in the flour mixture , mixing just until incorporated .	1
To make the cherry filling: Combine the cherry pie filling and cherry liquor.  Refrigerate cherry mixture until chilled, then fill cake.	to make the cherry filling : combine the cherry pie filling and cherry liquor . refrigerate cherry mixture until chilled , then fill cake .	1
In a medium bowl, stir together the flour, sugar, cocoa, baking soda, baking powder, salt and cinnamon. Add the eggs and oil, mix well. Fold in the nuts and zucchini until they are evenly distributed. Pour into the prepared pan.	in a medium bowl , stir together the flour , sugar , cocoa , baking soda , baking powder , salt and cinnamon . add the eggs and oil , mix well . fold in the nuts and zucchini until they are evenly distributed . pour into the prepared pan .	1
In a medium bowl, mix together cookie crumbs, 3 tablespoons sugar, and melted butter. Press mixture into the bottom of a 9 inch springform pan.	in a medium bowl , mix together cookie crumbs , 3 tablespoons sugar , and melted butter . press mixture into the bottom of a 9 inch springform pan .	1
In a large bowl, mix together cream cheese and 1/2 cup sugar until smooth. Beat in eggs one at a time. Blend in vanilla and melted white chocolate. Pour half of batter over crust. Spoon 3 tablespoons raspberry sauce over batter. Pour remaining cheesecake batter into pan, and again spoon 3 tablespoons raspberry sauce over the top. Swirl batter with the tip of a knife to create a marbled effect.	in a large bowl , mix together cream cheese and 1/2 cup sugar until smooth . beat in eggs one at a time . blend in vanilla and melted white chocolate . pour half of batter over crust . spoon 3 tablespoons raspberry sauce over batter . pour remaining cheesecake batter into pan , and again spoon 3 tablespoons raspberry sauce over the top . swirl batter with the tip of a knife to create a marbled effect .	1
In a large bowl, cream 1 cup butter and 2 cups sugar until light and fluffy. Beat in 4 egg yolks one at a time. Blend in the melted chocolate mixture and vanilla.  Beat in the flour mixture alternately with the buttermilk, mixing just until incorporated.	in a large bowl , cream 1 cup butter and 2 cups sugar until light and fluffy . beat in 4 egg yolks one at a time . blend in the melted chocolate mixture and vanilla . beat in the flour mixture alternatel y with the buttermilk , mixing just until incorporated .	1
In a large glass or metal mixing bowl, beat egg whites until stiff peaks form. Fold 1/3 of the whites into the batter, then quickly  fold in remaining whites until no streaks remain.	in a large glass or metal mixing bowl , beat egg whites until stiff peaks form . fold 1/3 of the whites into the batter , then quickly fold in remaining whites until no streaks remain .	1
To make the Filling:  In a saucepan combine 1 cup sugar, evaporated milk, 1/2 cup butter, and 3 egg yolks. Cook over low heat, stirring constantly until thickened. Remove from heat. Stir in coconut, pecans and vanilla. Cool until thick enough to spread.	to make the filling : in a saucepan combine 1 cup sugar , evaporated milk , 1/2 cup butter , and 3 egg yolks . cook over low heat , stirring constantly until thickened . remove from heat . stir in coconut , p ecans and vanilla . cool until thick enough to spread .	1
Spread filling between layers and on top of cake. In a small saucepan, melt shortening and 1 ounce of chocolate. Stir until smooth and drizzle down the sides of the cake.	spread filling between layers and on top of cake . in a small saucepan , melt shortening and 1 ounce of chocolate . stir until smooth and drizzle down the sides of the cake .	1
In a large bowl, combine cake mix, pudding mix, sour cream, eggs, oil and coffee liqueur. Beat until ingredients are well blended. Fold in chocolate chips. Batter will be thick. Spoon into prepared pan.	in a large bowl , combine cake mix , pudding mix , sour cream , eggs , oil and coffee liqueur . beat until ingredients are well blended . fold in chocolate chips . batter will be thick . spoon into prepared pa n.	1
Combine the beans and eggs in the bowl of a food processor. Process until smooth. Add the sugar and the baking powder, and pulse to blend. Pour in the melted chocolate and blend until smooth, scraping down the corners to make sure chocolate is completely mixed. Transfer the batter to the prepared cake pan.	combine the beans and eggs in the bowl of a food processor . process until smooth . add the sugar and the baking powder , and pulse to blend . pour in the melted chocolate and blend until smooth , scraping down the corners to make sure chocolate is completely mixed . transfer the batter to the prepared cake pan .	1
Bring Irish stout beer and 1 cup butter to a boil in a saucepan and set aside until butter has melted, stirring occasionally. Mix in cocoa powder until smooth.	bring irish stout beer and 1 cup butter to a boil in a saucepan and set aside until butter has melted , stirring occasionally . mix in cocoa powder until smooth .	1
Whisk together flour, sugar, baking soda, and salt in a bowl until thoroughly combined.	whisk together flour , sugar , baking soda , and salt in a bowl until thoroughly combined .	1
Beat eggs with sour cream in a large bowl with an electric mixer on low until well combined. Slowly beat in the beer mixture, then the flour mixture; beat until the batter is smooth.	beat eggs with sour cream in a large bowl with an electric mixer on low until well combined . slowly beat in the beer mixture , then the flour mixture ; beat until the batter is smooth .	1
Divide batter between the prepared cupcake cups, filling each cup about 2/3 full.	divide batter between the prepared cupcake cups , filling each cup about 2/3 full .	1
Cool the cupcakes completely. Cut cores out of the center of each cupcake with a sharp paring knife. Discard cores.	cool the cupcakes completely . cut cores out of the center of each cupcake with a sharp paring knife . discard cores .	1
Bring cream to a simmer in a saucepan over low heat; stir in bittersweet chocolate until melted.	bring cream to a simmer in a saucepan over low heat ; stir in bittersweet chocolate until melted .	1
Mix in 2 tablespoons butter and Irish whiskey until butter is melted; let mixture cool to room temperature. Filling will thicken as it cools.	mix in 2 tablespoons butter and irish whiskey until butter is melted ; let mixture cool to room temperature . filling will thicken as it cools .	1
Spoon the filling into the cored cupcakes.	spoon the filling into the cored cupcakes .	1
Set mixer to low speed and slowly beat in confectioners' sugar, 1 cup at a time, until frosting is smooth and spreadable. Beat in the Irish cream liqueur; adjust thickness of frosting with more confectioners' sugar if needed.	set mixer to low speed and slowly beat in confectioners ' sugar , 1 cup at a time , until frosting is smooth and spreadable . beat in the irish cream liqueur ; adjust thickness of frosting with more confec tioners ' sugar if needed .	1
Spread frosting on filled cupcakes.	spread frosting on filled cupcakes .	1
To make the frosting:  In a large bowl, beat the cream cheese with the white sugar and confectioners' sugar until smooth. Fold in the whipped topping, pecans and chopped chocolate. Spread between layers and on top and sides of cake.	to make the frosting : in a large bowl , beat the cream cheese with the white sugar and confectioners ' sugar until smooth . fold in the whipped topping , pecans and chopped chocolate . spread between laye rs and on top and sides of cake .	1
Whisk all-purpose flour, whole wheat flour, oats, baking soda, baking powder, and salt together in a bowl. Cut butter into flour mixture using a pastry blender until mixture resembles coarse meal.	whisk all-purpose flour , whole wheat flour , oats , baking soda , baking powder , and salt together in a bowl . cut butter into flour mixture using a pastry blender until mixture resembles coarse meal .	1
Beat buttermilk, egg, honey, and orange zest together in a bowl. Pour buttermilk mixture, currants, and raisins into flour mixture; stir with a wooden spoon until a wet, sticky dough comes together.	beat buttermilk , egg , honey , and orange zest together in a bowl . pour buttermilk mixture , currants , and raisins into flour mixture ; stir with a wooden spoon until a wet , sticky dough comes together .	1
Gently pound chicken breasts between 2 layers of plastic until each breast is evenly thick. Place breasts on a plate and season 1 side with kosher salt and black pepper. Sprinkle with flour; press flour to coat the entire surface and help it adhere. Turn and repeat on second side with salt, pepper, and flour.	gently pound chicken breasts between 2 layers of plastic until each breast is evenly thick . place breasts on a plate and season 1 side with kosher salt and black pepper . sprinkle with flour ; press flo ur to coat the entire surface and help it adhere . turn and repeat on second side with salt , pepper , and flour .	1
Brush excess flour from plate; place the chicken breasts back on the plate. Pour beaten egg over the breasts and coat each side. Cover bottom of a second plate with half the bread crumbs. Transfer chicken to the bread crumbs. Push crumbs up sides of chicken. Sprinkle on the remaining crumbs and thoroughly coat each side.	brush excess flour from plate ; place the chicken breasts back on the plate . pour beaten egg over the breasts and coat each side . cover bottom of a second plate with half the bread crumbs . transfer chi cken to the bread crumbs . push crumbs up sides of chicken . sprinkle on the remaining crumbs and thoroughly coat each side .	1
Mix ricotta and Cheddar cheese together in a bowl. Stir in salt, black pepper, cayenne, and olive oil. Spread half the cheese mixture on each breast without extending all the way to the edges. Dust with Parmigiano-Reggiano cheese and drizzle with olive oil.	mix ricotta and cheddar cheese together in a bowl . stir in salt , black pepper , cayenne , and olive oil . spread half the cheese mixture on each breast without extending all the way to the edges . dust wi th parmigiano-reggiano cheese and drizzle with olive oil .	1
To serve, ladle the heated marinara sauce in a wide circle on warm plates. Place chicken in center and sprinkle with chopped parsley.	to serve , ladle the heated marinara sauce in a wide circle on warm plates . place chicken in center and sprinkle with chopped parsley .	1
Mix mayonnaise, mustard, and cayenne together in a bowl to make the sauce.	mix mayonnaise , mustard , and cayenne together in a bowl to make the sauce .	1
Trim off ends of bread. Cut loaf in half and evenly split bread to make tops and bottoms of 2 sandwiches. Spread each half on both sides generously with the mayo/mustard sauce.	trim off ends of bread . cut loaf in half and evenly split bread to make tops and bottoms of 2 sandwiches . spread each half on both sides generously with the mayo/mustard sauce .	1
Divide sandwich ingredients between the two bottom halves in this order: 2 slices Swiss cheese, 3 slices ham, hot cooked pork, pickle slices, and 2 more slices of Swiss cheese. Place tops on sandwiches.	divide sandwich ingredients between the two bottom halves in this order : 2 slices swiss cheese , 3 slices ham , hot cooked pork , pickle slices , and 2 more slices of swiss cheese . place tops on sandwiche s.	1
Whisk 1 egg and 1 teaspoon water together in a bowl. Brush each bun with egg mixture. Sprinkle dough with sesame seeds.	whisk 1 egg and 1 teaspoon water together in a bowl . brush each bun with egg mixture . sprinkle dough with sesame seeds .	1
Line a baking sheet with a silicone mat or parchment paper.	line a baking sheet with a silicone mat or parchment paper .	1
Cut peeled and cored apples into quarters, cut each quarter into 3 wedges, and cut wedges into chunks.	cut peeled and cored apples into quarters , cut each quarter into 3 wedges , and cut wedges into chunks .	1
Form a dough piece into a ball, place on a floured work surface, and roll into a circle about 8 inches in diameter. Spoon 1/3 to 1/2 cup apple filling in the center. Fold dough over filling, leaving about 1 inch of dough on the bottom side visible below the top side. Gently press dough closed around filling, using your fingertips.	form a dough piece into a ball , place on a floured work surface , and roll into a circle about 8 inches in diameter . spoon 1/3 to 1/2 cup apple filling in the center . fold dough over filling , leaving a bout 1 inch of dough on the bottom side visible below the top side . gently press dough closed around filling , using your fingertips .	1
Fold the overhanging bottom part of the dough up over the top edge, working your way around the crust, and pinch the overhang tightly to the top part of the crust.	fold the overhanging bottom part of the dough up over the top edge , working your way around the crust , and pinch the overhang tightly to the top part of the crust .	1
Crimp the edge tightly closed, pinching a little bit of dough with the thumb and forefinger of one hand and using your index finger on the other hand to push a small notch into the pinched dough. Continue pinching and notching all the way around until the crust is tightly crimped together. Repeat with remaining dough and filling. Transfer pies onto prepared baking sheet.	crimp the edge tightly closed , pinching a little bit of dough with the thumb and forefinger of one hand and using your index finger on the other hand to push a small notch into the pinched dough . cont inue pinching and notching all the way around until the crust is tightly crimped together . repeat with remaining dough and filling . transfer pies onto prepared baking sheet .	1
Whisk egg with milk in a small bowl until thoroughly combined. Brush top of each hand pie with egg mixture and sprinkle with about 1/4 teaspoon white sugar. Cut 3 small vent holes in the top of each pie.	whisk egg with milk in a small bowl until thoroughly combined . brush top of each hand pie with egg mixture and sprinkle with about 1/4 teaspoon white sugar . cut 3 small vent holes in the top of each p ie .	1
Stir in beans and 1 more cup chicken broth. Cut cooled chicken breasts into cubes, add to the chili and bring to a simmer. Add remaining cup of chicken broth, season with salt, black pepper, sugar, and cayenne pepper to taste; cook until heated through. Serve garnished with green onions, sour cream, and cilantro.	stir in beans and 1 more cup chicken broth . cut cooled chicken breasts into cubes , add to the chili and bring to a simmer . add remaining cup of chicken broth , season with salt , black pepper , sugar , an d cayenne pepper to taste ; cook until heated through . serve garnished with green onions , sour cream , and cilantro .	1
Drizzle 1 tablespoon olive oil in the bottom of a large roasting pan. Place beef, pork, and chicken in pan and turn to coat with olive oil.	drizzle 1 tablespoon olive oil in the bottom of a large roasting pan . place beef , pork , and chicken in pan and turn to coat with olive oil .	1
Pour crushed tomatoes, 1 1/2 cups water, and tomato paste into onion mixture. Add roasted beef, pork, and chicken to tomato sauce mixture.	pour crushed tomatoes , 1Â 1/2 cups water , and tomato paste into onion mixture . add roasted beef , pork , and chicken to tomato sauce mixture .	1
Whisk flour, white sugar, baking powder, and salt in a mixing bowl. Cut in butter with a knife or pastry blender until the mixture resembles coarse crumbs.	whisk flour , white sugar , baking powder , and salt in a mixing bowl . cut in butter with a knife or pastry blender until the mixture resembles coarse crumbs .	1
Stir together 1/2 cup milk, sour cream, and currants in a small bowl; stir into flour mixture with a fork until just moistened and holding together.	stir together 1/2 cup milk , sour cream , and currants in a small bowl ; stir into flour mixture with a fork until just moistened and holding together .	1
Transfer dough to a lightly floured surface and pat into rectangle.	transfer dough to a lightly floured surface and pat into rectangle .	1
Fold the rectangle in thirds. Turn dough a half turn, gather any crumbs, flatten back into a rectangle, and repeat. Cut into eight pieces and place each scone on a silicone baking mat.	fold the rectangle in thirds . turn dough a half turn , gather any crumbs , flatten back into a rectangle , and repeat . cut into eight pieces and place each scone on a silicone baking mat .	1
Whisk egg and 1 tablespoon milk together in a small bowl; brush mixture on top of each scone.	whisk egg and 1 tablespoon milk together in a small bowl ; brush mixture on top of each scone .	1
Stir in roasted chicken broth and bring to a boil.	stir in roasted chicken broth and bring to a boil .	1
Mash garlic and a pinch of salt together in a mortar and pestle until smooth.	mash garlic and a pinch of salt together in a mortar and pestle until smooth .	1
Combine mashed garlic, olive oil, black pepper, and red pepper flakes in a large bowl. Add chicken wings and bread crumbs; toss to coat. Sprinkle with 1/2 cup Parmigiano-Reggiano cheese. Transfer to the prepared baking sheet and sprinkle with remaining 1/2 cup Parmigiano-Reggiano cheese.	combine mashed garlic , olive oil , black pepper , and red pepper flakes in a large bowl . add chicken wings and bread crumbs ; toss to coat . sprinkle with 1/2 cup parmigiano-reggiano cheese . transfer to t he prepared baking sheet and sprinkle with remaining 1/2 cup parmigiano-reggiano cheese .	1
Season chicken pieces all over with salt and black pepper.	season chicken pieces all over with salt and black pepper .	1
Pour rice into onion mixture and stir until rice is completely coated in onion mixture. Add chicken broth; stir. Place chicken pieces on top of rice, pressing down lightly until each piece is almost completely immersed in the broth. Pour any accumulated juices from the skillet into the pot. Bring mixture to a simmer and cover the pot with an oven-proof lid.	pour rice into onion mixture and stir until rice is completely coated in onion mixture . add chicken broth ; stir . place chicken pieces on top of rice , pressing down lightly until each piece is almost c ompletely immersed in the broth . pour any accumulated juices from the skillet into the pot . bring mixture to a simmer and cover the pot with an oven-proof lid .	1
Place chicken breast halves between two sheets of heavy plastic (resealable freezer bags work well) on a solid, level surface. Firmly pound chicken with the smooth side of a meat mallet to a thickness of 1/2-inch. Season with salt and pepper to taste.	place chicken breast halves between two sheets of heavy plastic -lrb- resealable freezer bags work well -rrb- on a solid , level surface . firmly pound chicken with the smooth side of a meat mallet to a thickness of 1/2-inch . season with salt and pepper to taste .	1
Stir in green onions and chipotle chile powder.	stir in green onions and chipotle chile powder .	1
Reduce heat to low. Using the spatula, smooth the surface of the eggs to move runny eggs to less runny spots, working toward an even thickness. As soon as surface is wet but not runny, remove from heat.	reduce heat to low . using the spatula , smooth the surface of the eggs to move runny eggs to less runny spots , working toward an even thickness . as soon as surface is wet but not runny , remove from hea t.	1
Starting at the handle side of the pan, use the spatula to begin rolling the omelette into a cylinder shape, about 3 rolls until omelette is about 2 inches from opposite side of pan. Use spatula to fold the last flap of egg over the top of the cylinder leaving the seam side up. Add cubes of the remaining 1/2 tablespoon butter to pan. Gently push the butter as it melts under the omelette.	starting at the handle side of the pan , use the spatula to begin rolling the omelette into a cylinder shape , about 3 rolls until omelette is about 2 inches from opposite side of pan . use spatula to fo ld the last flap of egg over the top of the cylinder leaving the seam side up . add cubes of the remaining 1/2 tablespoon butter to pan . gently push the butter as it melts under the omelette .	1
Slide omelette to edge of pan. Flip onto a plate with the seam side down. Even out the shape, if necessary. You can tuck in the ends, if you like. Brush surface with a bit more butter. Dust with cayenne pepper.	slide omelette to edge of pan . flip onto a plate with the seam side down . even out the shape , if necessary . you can tuck in the ends , if you like . brush surface with a bit more butter . dust with cayen ne pepper .	1
Heat oil and 1 tablespoon butter in heavy skillet over medium-high heat until butter melts and begins to foam. Add mushrooms and a pinch of salt; saute in hot butter and oil golden brown, about 5 minutes. Push mushroom to the edges to clear a space in the center of the skillet.	heat oil and 1 tablespoon butter in heavy skillet over medium-high heat until butter melts and begins to foam . add mushrooms and a pinch of salt ; saute in hot butter and oil golden brown , about 5 minu tes . push mushroom to the edges to clear a space in the center of the skillet .	1
Stir butter and parsley into mushroom mixture. Stir constantly until butter melts and forms a sauce; remove from heat and season with salt and black pepper. Spoon sauce and mushrooms over halibut.	stir butter and parsley into mushroom mixture . stir constantly until butter melts and forms a sauce ; remove from heat and season with salt and black pepper . spoon sauce and mushrooms over halibut .	1
Toss together chicken pieces, black pepper, salt, paprika, rosemary, thyme, oregano, sage, white pepper, and cayenne in a large bowl to coat.	toss together chicken pieces , black pepper , salt , paprika , rosemary , thyme , oregano , sage , white pepper , and cayenne in a large bowl to coat .	1
Combine flour, salt, paprika, cayenne, garlic powder, white pepper, and onion powder in a large shallow dish.	combine flour , salt , paprika , cayenne , garlic powder , white pepper , and onion powder in a large shallow dish .	1
Remove chicken from the buttermilk and dredge each piece in the seasoned flour. Shake off any excess and transfer to a plate.	remove chicken from the buttermilk and dredge each piece in the seasoned flour . shake off any excess and transfer to a plate .	1
Mix cornmeal and bread crumbs together in a bowl; stir in 1/2 teaspoon salt, black pepper, and cayenne pepper to taste. Beat eggs with milk in a separate bowl. Place flour into a third bowl.	mix cornmeal and bread crumbs together in a bowl ; stir in 1/2 teaspoon salt , black pepper , and cayenne pepper to taste . beat eggs with milk in a separate bowl . place flour into a third bowl .	1
Combine sweet pickle relish, mayonnaise, and hot sauce in a small bowl to make the remoulade sauce.	combine sweet pickle relish , mayonnaise , and hot sauce in a small bowl to make the remoulade sauce .	1
Transfer fried green tomatoes to a serving platter and serve with remoulade sauce.	transfer fried green tomatoes to a serving platter and serve with remoulade sauce .	1
Season chicken thighs with salt on both sides.	season chicken thighs with salt on both sides .	1
Combine salsa verde, green chilies, garlic, jalapeno, and cilantro in a blender. Blend, starting on low and finishing on high, until sauce is very smooth and bright green.	combine salsa verde , green chilies , garlic , jalapeno , and cilantro in a blender . blend , starting on low and finishing on high , until sauce is very smooth and bright green .	1
Cut chicken into bite-sized pieces and transfer back into the bowl. Combine chicken pieces, accumulated juices, and the green sauce into a pot. Season with cumin, chipotle pepper, black pepper, oregano, and salt.	cut chicken into bite-sized pieces and transfer back into the bowl . combine chicken pieces , accumulated juices , and the green sauce into a pot . season with cumin , chipotle pepper , black pepper , oregan o , and salt .	1
Season chicken legs with salt on all sides.	season chicken legs with salt on all sides .	1
Place coconut milk, water, garlic, jalapeno peppers, cilantro, and green onion into a blender. Cover and puree until smooth. Set aside.	place coconut milk , water , garlic , jalapeno peppers , cilantro , and green onion into a blender . cover and puree until smooth . set aside .	1
Place chicken legs in a single layer on top of onions and ginger. Pour pureed coconut mixture, lime juice, fish sauce, and brown sugar over the chicken.	place chicken legs in a single layer on top of onions and ginger . pour pureed coconut mixture , lime juice , fish sauce , and brown sugar over the chicken .	1
Stir basil into coconut milk mixture; season with salt and pepper to taste.	stir basil into coconut milk mixture ; season with salt and pepper to taste .	1
Beat eggs in a bowl with salt, black pepper, and cayenne pepper until thoroughly combined.	beat eggs in a bowl with salt , black pepper , and cayenne pepper until thoroughly combined .	1
Saute chopped spinach with bacon and onion until spinach is hot; pour in eggs. Use a wooden spoon to distribute spinach evenly throughout the eggs. Sprinkle feta cheese over mixture.	saute chopped spinach with bacon and onion until spinach is hot ; pour in eggs . use a wooden spoon to distribute spinach evenly throughout the eggs . sprinkle feta cheese over mixture .	1
Whisk orange juice, brown sugar, rice vinegar, fish sauce, soy sauce, ginger, and crushed red pepper flakes in a large bowl.	whisk orange juice , brown sugar , rice vinegar , fish sauce , soy sauce , ginger , and crushed red pepper flakes in a large bowl .	1
Remove chicken from refrigerator and drain thoroughly in colander, reserving marinade.	remove chicken from refrigerator and drain thoroughly in colander , reserving marinade .	1
Remove from heat. Garnish with cilantro and serve.	remove from heat . garnish with cilantro and serve .	1
Place slices of beef on a work surface, Season both sides with kosher salt and pepper. Spread one side with mustard. Place bacon strips on the mustard and sprinkle with paprika. Arrange onion slices cross-wise on the beef. Then evenly space 3 pickle slices across each slice of beef. Keep about an inch of the narrowest end of the beef slice free of toppings to facilitate rolling it up.	place slices of beef on a work surface , season both sides with kosher salt and pepper . spread one side with mustard . place bacon strips on the mustard and sprinkle with paprika . arrange onion slices c ross-wise on the beef . then evenly space 3 pickle slices across each slice of beef . keep about an inch of the narrowest end of the beef slice free of toppings to facilitate rolling it up .	1
Roll each slice of meat, beginning from the wider of the two short ends, working to keep all ingredients inside the roll. Rolls should be nice and tight. Secure the rolls (seam side down) with 3 loops of butcher's twine, one in the middle and one at each end. Trim excess string.	roll each slice of meat , beginning from the wider of the two short ends , working to keep all ingredients inside the roll . rolls should be nice and tight . secure the rolls -lrb- seam side down -rrb- with 3 loops of butcher 's twine , one in the middle and one at each end . trim excess string .	1
Scoop out a small portion of dough using a teaspoon. Using a second spoon, shape into a rounded oval. Repeat until you have enough gnocchi for a batch, about 6 or so.	scoop out a small portion of dough using a teaspoon . using a second spoon , shape into a rounded oval . repeat until you have enough gnocchi for a batch , about 6 or so .	1
Bring a large pot of salted water to a simmer. Drop shaped gnocchi in batches into pot as you form them. After a minute or so they will rise to the surface. Continue simmering until they spring back to the touch when you remove one from the water to test it, 2 to 3 more minutes. Transfer to a plate with a slotted spoon to cool. Repeat with the remaining dough.	bring a large pot of salted water to a simmer . drop shaped gnocchi in batches into pot as you form them . after a minute or so they will rise to the surface . continue simmering until they spring back t o the touch when you remove one from the water to test it , 2 to 3 more minutes . transfer to a plate with a slotted spoon to cool . repeat with the remaining dough .	1
Optional step: Melt butter in a skillet until bubbling. Add cooked gnocchi and brown on each side. Serve with a dusting of grated Parmesan cheese and a drizzle of the butter from the pan.	optional step : melt butter in a skillet until bubbling . add cooked gnocchi and brown on each side . serve with a dusting of grated parmesan cheese and a drizzle of the butter from the pan .	1
Remove chicken from pot, and allow to cool for a few minutes. When cool enough to handle, remove all meat from the bones, and set the chicken meat aside. Pour stock into a bowl and set aside.	remove chicken from pot , and allow to cool for a few minutes . when cool enough to handle , remove all meat from the bones , and set the chicken meat aside . pour stock into a bowl and set aside .	1
Stir milk into the sauce, and gently mix in the reserved chicken meat, herbes de Provence, tarragon, and rosemary. Bring stew back to a simmer, and cook for 10 more minutes. Pop open the can of biscuits, separate, and place biscuits on top of stew.	stir milk into the sauce , and gently mix in the reserved chicken meat , herbes de provence , tarragon , and rosemary . bring stew back to a simmer , and cook for 10 more minutes . pop open the can of biscui ts , separate , and place biscuits on top of stew .	1
Combine lamb, rice, 2 teaspoons salt, 1/4 cup parsley, almonds, and currants in a large bowl. Add cooled onion mixture and mix until combined. Cover and place in the refrigerator until ready to use.	combine lamb , rice , 2 teaspoons salt , 1/4 cup parsley , almonds , and currants in a large bowl . add cooled onion mixture and mix until combined . cover and place in the refrigerator until ready to use .	1
Take 1 cabbage leaf and remove the root end. Place about 1/2 cup of the lamb mixture toward the bottom edge of the cabbage leaf and roll into a log. Repeat with remaining lamb mixture and 7 more large leaves to create 8 cabbage rolls.	take 1 cabbage leaf and remove the root end . place about 1/2 cup of the lamb mixture toward the bottom edge of the cabbage leaf and roll into a log . repeat with remaining lamb mixture and 7 more large leaves to create 8 cabbage rolls .	1
Line the bottom of a large casserole dish or Dutch oven with 4 or 5 smaller cabbage leaves. Place cabbage rolls on top; season with salt and black pepper. Add bay leaves and tomato puree. Pour in chicken broth. Sprinkle 1/2 sliced onion over the top and cover with 3 or 4 more cabbage leaves. Cover casserole.	line the bottom of a large casserole dish or dutch oven with 4 or 5 smaller cabbage leaves . place cabbage rolls on top ; season with salt and black pepper . add bay leaves and tomato puree . pour in chic ken broth . sprinkle 1/2 sliced onion over the top and cover with 3 or 4 more cabbage leaves . cover casserole .	1
Combine chicken, cream cheese, hot pepper sauce, 1/2 cup pepper Jack cheese, blue cheese dressing, crumbled blue cheese, seafood seasoning, and cayenne pepper in a large bowl.	combine chicken , cream cheese , hot pepper sauce , 1/2 cup pepper jack cheese , blue cheese dressing , crumbled blue cheese , seafood seasoning , and cayenne pepper in a large bowl .	1
Transfer chicken mixture to a 9-inch round baking dish and sprinkle with 2 tablespoons pepper Jack cheese.	transfer chicken mixture to a 9 inch round baking dish and sprinkle with 2 tablespoons pepper jack cheese .	1
Pour in reserved clam juice and cook until most of the liquid has evaporated. Transfer vegetable mixture to plate to cool.	pour in reserved clam juice and cook until most of the liquid has evaporated . transfer vegetable mixture to plate to cool .	1
Open second can of clams and drain juice, combine with reserved clams, cream cheese, bacon, cooled vegetables, juice from lemon, and freshly ground black pepper and hot sauce to taste. Transfer to serving bowl and garnish with chopped bacon and green onion. Serve with crackers.	open second can of clams and drain juice , combine with reserved clams , cream cheese , bacon , cooled vegetables , juice from lemon , and freshly ground black pepper and hot sauce to taste . transfer to ser ving bowl and garnish with chopped bacon and green onion . serve with crackers .	1
Transfer onion halves to a bowl with a slotted spoon; transfer chicken thighs to a separate bowl.	transfer onion halves to a bowl with a slotted spoon ; transfer chicken thighs to a separate bowl .	1
Pour broth through a strainer into a large bowl.	pour broth through a strainer into a large bowl .	1
Dice chicken into small cubes. Transfer to a mixing bowl. Add celery, blue cheese, cream cheese, and hot sauce. Season with salt, black pepper, and cayenne pepper. Mix with a spoon until filling is well combined.	dice chicken into small cubes . transfer to a mixing bowl . add celery , blue cheese , cream cheese , and hot sauce . season with salt , black pepper , and cayenne pepper . mix with a spoon until filling is we ll combined .	1
Beat egg and water together. Brush egg wash over the edges of 1 wonton wrapper. Place a heaping tablespoon of filling near one edge. Spread out with your fingers, leaving a 1/2-inch border. Roll edge up over filling. Crimp in both edges and roll over once more. Fold in about 1/4 inch of dough on either side to seal the ends. Apply more egg wash on top and continue rolling. Place on a plastic-lined baking pan. Repeat with remaining wonton wrappers and filling.	beat egg and water together . brush egg wash over the edges of 1 wonton wrapper . place a heaping tablespoon of filling near one edge . spread out with your fingers , leaving a 1/2-inch border . roll edge up over filling . crimp in both edges and roll over once more . fold in about 1/4 inch of dough on either side to seal the ends . apply more egg wash on top and continue rolling . place on a plastic-lined baking pan . repeat with remaining wonton wrappers and filling .	1
Heat oil over high heat in a skillet. Stir in chicken.	heat oil over high heat in a skillet . stir in chicken .	1
Garnish with cilantro and serve.	garnish with cilantro and serve .	1
Preheat an outdoor grill for medium-high heat, and lightly oil the grate.	preheat an outdoor grill for medium-high heat , and lightly oil the grate .	1
Combine 1/2 cup yogurt, 1 tablespoon lemon juice, and harissa in a small bowl. Set aside.	combine 1/2 cup yogurt , 1 tablespoon lemon juice , and harissa in a small bowl . set aside .	1
Remove chicken from bag and transfer to a plate or baking sheet lined with paper towels. Pat chicken pieces dry with more paper towels. Season with pinch of salt.	remove chicken from bag and transfer to a plate or baking sheet lined with paper towels . pat chicken pieces dry with more paper towels . season with pinch of salt .	1
Serve chicken with the yogurt harissa mixture on the side.	serve chicken with the yogurt harissa mixture on the side .	1
Beat eggs and milk together in a shallow bowl. Whisk flour, salt, black pepper, and cayenne pepper together in another shallow bowl.	beat eggs and milk together in a shallow bowl . whisk flour , salt , black pepper , and cayenne pepper together in another shallow bowl .	1
Gently press chicken into flour mixture to coat; shake off excess flour. Dip into egg mixture and coat completely.	gently press chicken into flour mixture to coat ; shake off excess flour . dip into egg mixture and coat completely .	1
Dry the outside of chicken with paper towels. Tuck the wing tips underneath the chicken and  place into a large oven-safe skillet. Use scissors to snip off the tail, if desired.	dry the outside of chicken with paper towels . tuck the wing tips underneath the chicken and place into a large oven-safe skillet . use scissors to snip off the tail , if desired .	1
Generously sprinkle kosher salt into the cavity and over the back and sides of chicken. Tie chicken legs together with kitchen twine. Sprinkle salt generously over the breasts, coating them thoroughly. Wipe excess salt out of skillet with paper towels.	generously sprinkle kosher salt into the cavity and over the back and sides of chicken . tie chicken legs together with kitchen twine . sprinkle salt generously over the breasts , coating them thoroughly . wipe excess salt out of skillet with paper towels .	1
Combine peanut butter, lime juice, and 1 teaspoon Asian chile pepper sauce in a small bowl; stir until thoroughly combined.	combine peanut butter , lime juice , and 1 teaspoon asian chile pepper sauce in a small bowl ; stir until thoroughly combined .	1
Mix carrot, cucumber, and jalapeno pepper in a bowl; stir in fish sauce and rice vinegar. Set aside.	mix carrot , cucumber , and jalapeno pepper in a bowl ; stir in fish sauce and rice vinegar . set aside .	1
Mix garlic, coconut milk, cumin, turmeric, and 1 teaspoon Asian chile pepper sauce in a bowl. Add bread crumbs and soy sauce to the mixture. Stir in ground chicken and basil until thoroughly combined. Mixture will be soft.	mix garlic , coconut milk , cumin , turmeric , and 1 teaspoon asian chile pepper sauce in a bowl . add bread crumbs and soy sauce to the mixture . stir in ground chicken and basil until thoroughly combined . mixture will be soft .	1
Break off a small piece of chicken mixture and fry in a nonstick skillet over medium heat until chicken is browned and no longer pink. Taste the little cooked piece and season the raw chicken mixture to taste with salt and cayenne pepper. Do not eat raw chicken mix.	break off a small piece of chicken mixture and fry in a nonstick skillet over medium heat until chicken is browned and no longer pink . taste the little cooked piece and season the raw chicken mixture to taste with salt and cayenne pepper . do not eat raw chicken mix .	1
Spread about 1 teaspoon of peanut spread onto each bun half; top bun bottoms with a chicken patty, about 1/4 cup of the carrot slaw, and 1 tablespoon of cilantro leaves. Place tops of buns on burgers to serve.	spread about 1 teaspoon of peanut spread onto each bun half ; top bun bottoms with a chicken patty , about 1/4 cup of the carrot slaw , and 1 tablespoon of cilantro leaves . place tops of buns on burgers to serve .	1
Gently stir mascarpone cheese into squash mixture until completely incorporated. Stir in Italian parsley. Remove from heat and cover.	gently stir mascarpone cheese into squash mixture until completely incorporated . stir in italian parsley . remove from heat and cover .	1
Pour butternut-mascarpone sauce over spaghetti, stirring until combined. Sprinkle Parmigiano-Reggiano cheese over spaghetti and serve.	pour butternut-mascarpone sauce over spaghetti , stirring until combined . sprinkle parmigiano-reggiano cheese over spaghetti and serve .	1
Serve in bowls and sprinkle each serving with a dusting of Parmigiano-Reggiano cheese and a pinch of red pepper flakes.	serve in bowls and sprinkle each serving with a dusting of parmigiano-reggiano cheese and a pinch of red pepper flakes .	1
Mix salt, coriander, cumin, turmeric, paprika, and cayenne pepper together in a small bowl.	mix salt , coriander , cumin , turmeric , paprika , and cayenne pepper together in a small bowl .	1
Place chicken pieces in a separate bowl and add 1/2 of the spice blend. Mix together thoroughly to coat each surface with spice blend.	place chicken pieces in a separate bowl and add 1/2 of the spice blend . mix together thoroughly to coat each surface with spice blend .	1
Heat oil over high heat in a heavy pot. Brown half of the chicken pieces on all sides. Transfer to a bowl. Repeat with the rest of the chicken.	heat oil over high heat in a heavy pot . brown half of the chicken pieces on all sides . transfer to a bowl . repeat with the rest of the chicken .	1
Serve over rice with a squeeze of lime and a sprinkle of peanuts and chopped cilantro.	serve over rice with a squeeze of lime and a sprinkle of peanuts and chopped cilantro .	1
Season chicken breasts all over with salt and pepper.	season chicken breasts all over with salt and pepper .	1
Move chicken to one side of the skillet and tilt the skillet so that the sauce pools at the bottom. Stir parsley and 1 teaspoon cold butter into the sauce, stirring constantly, until sauce is shiny and butter is completely melted. Transfer chicken breasts to plates and spoon mushrooms and sauce over the top.	move chicken to one side of the skillet and tilt the skillet so that the sauce pools at the bottom . stir parsley and 1 teaspoon cold butter into the sauce , stirring constantly , until sauce is shiny an d butter is completely melted . transfer chicken breasts to plates and spoon mushrooms and sauce over the top .	1
When sausages are cool enough to handle, cut them into serving pieces, about 2-inch slices. Transfer back to pan along with any accumulated juices from the cutting board.	when sausages are cool enough to handle , cut them into serving pieces , about 2 inch slices . transfer back to pan along with any accumulated juices from the cutting board .	1
Cut two slashes down to the bone on the skin side of each chicken thigh.	cut two slashes down to the bone on the skin side of each chicken thigh .	1
Depending on the size of the peppers, halve or quarter them and place in a large mixing bowl. Add the sliced red and yellow onions and potato chunks. Add chicken thighs and sausage pieces with pan juices.	depending on the size of the peppers , halve or quarter them and place in a large mixing bowl . add the sliced red and yellow onions and potato chunks . add chicken thighs and sausage pieces with pan jui ces .	1
Season with kosher salt, black pepper, and Italian herbs. Drizzle with a tablespoon of olive oil.	season with kosher salt , black pepper , and italian herbs . drizzle with a tablespoon of olive oil .	1
Preheat an outdoor grill for medium-high heat and lightly oil the grate.	preheat an outdoor grill for medium-high heat and lightly oil the grate .	3
Place chicken and chorizo in a large bowl; add olive oil, sherry vinegar, oregano, cayenne pepper, black pepper, and salt. Stir until chicken and chorizo are completely coated.	place chicken and chorizo in a large bowl ; add olive oil , sherry vinegar , oregano , cayenne pepper , black pepper , and salt . stir until chicken and chorizo are completely coated .	1
Set a strainer over a bowl. Strain berries, using a spatula to push through as much juice as possible. Discard skins.	set a strainer over a bowl . strain berries , using a spatula to push through as much juice as possible . discard skins .	1
Preheat an outdoor grill for medium-high heat and lightly oil the grate. Drain excess marinade from chicken.	preheat an outdoor grill for medium-high heat and lightly oil the grate . drain excess marinade from chicken .	1
Serve breasts on a swirl of blueberry sauce with more sauce drizzled on top.	serve breasts on a swirl of blueberry sauce with more sauce drizzled on top .	1
Brush the inside of an oven-proof skillet with vegetable oil. Set aside.	brush the inside of an oven-proof skillet with vegetable oil . set aside .	1
Mix cherries, bread crumbs, egg yolk, Parmigiano-Reggiano cheese, olive oil, thyme, oregano, garlic, salt, black pepper, and cayenne pepper until combined.	mix cherries , bread crumbs , egg yolk , parmigiano-reggiano cheese , olive oil , thyme , oregano , garlic , salt , black pepper , and cayenne pepper until combined .	1
Cut a 1-inch slit in each chicken breast by slicing at an angle from the thick end of the breast toward the thinner end.	cut a 1 inch slit in each chicken breast by slicing at an angle from the thick end of the breast toward the thinner end .	1
Open flap and place one butterflied chicken breast between two sheets of heavy plastic (resealable freezer bags work well) on a solid, level surface. Firmly pound chicken with the smooth side of a meat mallet to a thickness of 1/2-inch. Repeat with the other breast.	open flap and place one butterflied chicken breast between two sheets of heavy plastic -lrb- resealable freezer bags work well -rrb- on a solid , level surface . firmly pound chicken with the smooth side of a mea t mallet to a thickness of 1/2-inch . repeat with the other breast .	1
Place half the stuffing on each chicken breast, place each breast on a piece of plastic wrap and roll into a tight roll, twisting the ends of the plastic wrap to hold create a tight package.	place half the stuffing on each chicken breast , place each breast on a piece of plastic wrap and roll into a tight roll , twisting the ends of the plastic wrap to hold create a tight package .	1
On a piece of plastic wrap, slightly overlap 2 slices of prosciutto so they are as wide as the rolled chicken breast. Unwrap rolled chicken breast and place the breast at one end of the prosciutto. Roll prosciutto around the stuffed breast using the plastic to make a tight roll. Repeat with the second stuffed breast and remaining 2 slices of prosciutto.	on a piece of plastic wrap , slightly overlap 2 slices of prosciutto so they are as wide as the rolled chicken breast . unwrap rolled chicken breast and place the breast at one end of the prosciutto . ro ll prosciutto around the stuffed breast using the plastic to make a tight roll . repeat with the second stuffed breast and remaining 2 slices of prosciutto .	1
Lay 4 pieces of string on the cutting board, about 1-inch apart. Place chicken roll across the strings, and tie each into a knot to keep the chicken from unrolling. Repeat for the second stuffed breast.	lay 4 pieces of string on the cutting board , about 1 inch apart . place chicken roll across the strings , and tie each into a knot to keep the chicken from unrolling . repeat for the second stuffed breas t.	1
Remove twine from chicken breasts; slice into bite-sized pieces. Serve drizzled with pan sauce.	remove twine from chicken breasts ; slice into bite-sized pieces . serve drizzled with pan sauce .	1
Remove chicken breasts from brine, discard the brine, and dry chicken breasts with paper towels. Brush each breast with olive oil and season each with salt, black pepper, and cayenne pepper.	remove chicken breasts from brine , discard the brine , and dry chicken breasts with paper towels . brush each breast with olive oil and season each with salt , black pepper , and cayenne pepper .	1
Season chicken breasts on both sides with salt, black pepper, and cayenne.	season chicken breasts on both sides with salt , black pepper , and cayenne .	1
Combine mayonnaise, balsamic vinegar, and Dijon mustard in a small bowl. Spread 'glue' over the top and sides of the chicken breasts. Spoon over the the breadcrumb mixture. Use a spatula to transfer chicken breasts back to the skillet. Pour chicken broth around the chicken.	combine mayonnaise , balsamic vinegar , and dijon mustard in a small bowl . spread ` glue ' over the top and sides of the chicken breasts . spoon over the the breadcrumb mixture . use a spatula to transfer c hicken breasts back to the skillet . pour chicken broth around the chicken .	1
Place bacon in a large, deep skillet. Cook over medium high heat until evenly brown. Reserving drippings, drain bacon, crumble, and set aside.	place bacon in a large , deep skillet . cook over medium high heat until evenly brown . reserving drippings , drain bacon , crumble , and set aside .	1
In a large bowl, mix the bacon and the onion mixture into the rice mixture. Season with the Italian parsley and dried mixed herbs.	in a large bowl , mix the bacon and the onion mixture into the rice mixture . season with the italian parsley and dried mixed herbs .	1
Heat olive oil in a large Dutch oven over medium-high heat; add chicken and cook until browned on the outside. Remove to a bowl to capture the juices.	heat olive oil in a large dutch oven over medium-high heat ; add chicken and cook until browned on the outside . remove to a bowl to capture the juices .	1
Place chicken pieces and any juices that have accumulated in the bowl on top of the cooked vegetables. Add more salt and pepper. Place pepper slices on top of the chicken.	place chicken pieces and any juices that have accumulated in the bowl on top of the cooked vegetables . add more salt and pepper . place pepper slices on top of the chicken .	1
Whisk cornstarch, flour, sugar, 1/2 teaspoon black pepper, and 1/4 teaspoon salt together in a large bowl. Gradually whisk ice water into flour in until mixture resembles a smooth pancake batter. Transfer chicken to batter and stir to coat chicken completely.	whisk cornstarch , flour , sugar , 1/2 teaspoon black pepper , and 1/4 teaspoon salt together in a large bowl . gradually whisk ice water into flour in until mixture resembles a smooth pancake batter . tran sfer chicken to batter and stir to coat chicken completely .	1
Combine flour, black pepper, garlic salt, onion salt, and cayenne pepper in a large bowl.	combine flour , black pepper , garlic salt , onion salt , and cayenne pepper in a large bowl .	1
Set oven rack about 6 inches from the heat source and preheat the oven's broiler. Line a baking sheet with aluminum foil and grease with vegetable oil.	set oven rack about 6 inches from the heat source and preheat the oven 's broiler . line a baking sheet with aluminum foil and grease with vegetable oil .	1
Arrange chicken thighs on prepared baking sheet. Discard excess marinade.	arrange chicken thighs on prepared baking sheet . discard excess marinade .	1
Remove all chicken pieces and sausage using a slotted spoon. Pour broth into different bowl and set aside. When chicken is cool enough to handle, remove skin and bones; set chicken meat and sausage aside.	remove all chicken pieces and sausage using a slotted spoon . pour broth into different bowl and set aside . when chicken is cool enough to handle , remove skin and bones ; set chicken meat and sausage as ide .	1
Make 2 slashes crosswise into the skin and meat of each chicken thigh with a sharp knife, cutting to the bone. Cuts should be about 1 inch apart. Transfer thighs into a heavy resealable plastic bag.	make 2 slashes crosswise into the skin and meat of each chicken thigh with a sharp knife , cutting to the bone . cuts should be about 1 inch apart . transfer thighs into a heavy resealable plastic bag .	1
Whisk Dijon mustard, brown sugar, red wine vinegar, mustard powder, salt, black pepper, ground chipotle pepper, and cayenne pepper in a bowl until smooth. Whisk garlic into marinade.	whisk dijon mustard , brown sugar , red wine vinegar , mustard powder , salt , black pepper , ground chipotle pepper , and cayenne pepper in a bowl until smooth . whisk garlic into marinade .	1
Scatter onion rings onto prepared baking sheet. Place chicken thighs on top of onion rings. Spray or brush thighs with vegetable oil; sprinkle thighs with additional salt and cayenne pepper if desired.	scatter onion rings onto prepared baking sheet . place chicken thighs on top of onion rings . spray or brush thighs with vegetable oil ; sprinkle thighs with additional salt and cayenne pepper if desired .	1
Spoon reduced pan sauce over each chicken thigh and serve.	spoon reduced pan sauce over each chicken thigh and serve .	1
Place orange juice, lemon juice, and lime juice in a bowl. Add garlic, kosher salt, annatto powder, chipotle powder, ground cumin, cayenne, oregano, and black pepper. Whisk until well blended.	place orange juice , lemon juice , and lime juice in a bowl . add garlic , kosher salt , annatto powder , chipotle powder , ground cumin , cayenne , oregano , and black pepper . whisk until well blended .	1
Transfer pieces of pork from marinade to a paper-towel-lined bowl to absorb most of the moisture. Discard paper towels. Drizzle vegetable oil and a bit more annatto powder on the pork.	transfer pieces of pork from marinade to a paper-towel-lined bowl to absorb most of the moisture . discard paper towels . drizzle vegetable oil and a bit more annatto powder on the pork .	1
Remove skillet from heat and stir bacon, butter, vinegar, salt, and pepper into Brussels sprouts mixture until butter is melted.	remove skillet from heat and stir bacon , butter , vinegar , salt , and pepper into brussels sprouts mixture until butter is melted .	1
Add the garlic and almonds to the fat in the skillet and cook briefly over medium heat until toasted. Add the Brussels sprouts and quickly toss to coat with the hot oil. Sprinkle the red wine vinegar over the sprouts and toss again to coat. Cook, stirring frequently, until sprouts are wilted. Remove from the heat, stir in the bacon and season to taste with salt and pepper.	add the garlic and almonds to the fat in the skillet and cook briefly over medium heat until toasted . add the brussels sprouts and quickly toss to coat with the hot oil . sprinkle the red wine vinegar over the sprouts and toss again to coat . cook , stirring frequently , until sprouts are wilted . remove from the heat , stir in the bacon and season to taste with salt and pepper .	1
Mash about 1/4 of the beans in a small bowl, stir all the beans into the pan.	mash about 1/4 of the beans in a small bowl , stir all the beans into the pan .	1
Stir in cayenne, rosemary and thyme. Add reserved meat back to the pan. Stir in remaining cup of stock or more if needed to cover. Return to simmer.	stir in cayenne , rosemary and thyme . add reserved meat back to the pan . stir in remaining cup of stock or more if needed to cover . return to simmer .	1
Mix bread crumbs, Parmigiano-Reggiano and melted butter together in a small bowl.	mix bread crumbs , parmigiano-reggiano and melted butter together in a small bowl .	1
Preheat the oven's broiler and set the oven rack about 7 inches from the heat source.	preheat the oven 's broiler and set the oven rack about 7 inches from the heat source .	1
Remove the pan and push bread crumbs down into the cassoulet. Top with remaining bread crumb mixture. Return to oven and continue broiling 5 more minutes, until browned.	remove the pan and push bread crumbs down into the cassoulet . top with remaining bread crumb mixture . return to oven and continue broiling 5 more minutes , until browned .	1
Remove and discard the skin from the chicken. Wash parts and pat dry. Combine the garlic and ginger and rub over the chicken. Place the chicken parts in a 9x13 inch baking dish, cover with foil and set aside.	remove and discard the skin from the chicken . wash parts and pat dry . combine the garlic and ginger and rub over the chicken . place the chicken parts in a 9 x13 inch baking dish , cover with foil and se t aside .	1
Meanwhile, place the cilantro, cumin, jalapeno chile pepper and lemon juice in a blender and puree until smooth, adding some water if necessary. Set this aside for later. In a separate small bowl, combine the cashews with the cream. Mix well and pour over the chicken.	meanwhile , place the cilantro , cumin , jalapeno chile pepper and lemon juice in a blender and puree until smooth , adding some water if necessary . set this aside for later . in a separate small bowl , com bine the cashews with the cream . mix well and pour over the chicken .	1
Remove from oven and combine the gravy in the dish with the reserved cilantro chutney. Mix this well and serve over the chicken.	remove from oven and combine the gravy in the dish with the reserved cilantro chutney . mix this well and serve over the chicken .	1
Lay a game hen breast side-down on a work surface; use kitchen shears or a sharp knife to cut the backbone out of the game hen, cutting through each side of the bone from top to bottom. Remove the backbone. Use a sharp knife to slice through the cartilage of the breastbone. Flip game hen breast side-up, flatten bird lightly with your hands, and twist the wing tips underneath the wings. Repeat for remaining game hen.	lay a game hen breast side-down on a work surface ; use kitchen shears or a sharp knife to cut the backbone out of the game hen , cutting through each side of the bone from top to bottom . remove the bac kbone . use a sharp knife to slice through the cartilage of the breastbone . flip game hen breast side-up , flatten bird lightly with your hands , and twist the wing tips underneath the wings . repeat for remaining game hen .	1
Place white wine vinegar, vegetable oil, rosemary, orange juice, garlic, egg, Calabrian chili sauce, orange zest, kosher salt, and anchovy fillet into a blender. Pulse several times to combine; blend until marinade is smooth and creamy.	place white wine vinegar , vegetable oil , rosemary , orange juice , garlic , egg , calabrian chili sauce , orange zest , kosher salt , and anchovy fillet into a blender . pulse several times to combine ; blend until marinade is smooth and creamy .	1
Preheat grill for medium heat and lightly oil the grate.	preheat grill for medium heat and lightly oil the grate .	1
Remove game hens from marinade, reserving marinade. Dry birds on paper towels. Season breast sides with salt.	remove game hens from marinade , reserving marinade . dry birds on paper towels . season breast sides with salt .	1
In a medium bowl, mix the cumin, cayenne pepper, turmeric, and coriander. Place the chicken in the bowl, season with salt and pepper, and rub on all sides with the spice mixture.	in a medium bowl , mix the cumin , cayenne pepper , turmeric , and coriander . place the chicken in the bowl , season with salt and pepper , and rub on all sides with the spice mixture .	1
With a hand mixer or in a blender, puree the mixture until smooth. Return to the saucepan, and reheat. Season with nutmeg, salt, and pepper.	with a hand mixer or in a blender , puree the mixture until smooth . return to the saucepan , and reheat . season with nutmeg , salt , and pepper .	1
Prick potatoes with a fork and cook in the microwave, 3 or 4 at a time, and scoop out the flesh (while the others are cooking).	prick potatoes with a fork and cook in the microwave , 3 or 4 at a time , and scoop out the flesh -lrb- while the others are cooking -rrb- .	1
In a large saucepan over medium heat, melt butter.  Stir in flour and cook about a minute.  Whisk in milk, a little at a time, stirring constantly until thickened.  Stir in potatoes, salt, pepper, 1/3 cup bacon bits, 2 tablespoons green onions and most of the cheese.  Cook until thoroughly heated.  Stir in sour cream and heat through.  Serve topped with remaining bacon, onions and cheese.	in a large saucepan over medium heat , melt butter . stir in flour and cook about a minute . whisk in milk , a little at a time , stirring constantly until thickened . stir in potatoes , salt , pepper , 1/3 cup bacon bits , 2 tablespoons green onions and most of the cheese . cook until thoroughly heated . stir in sour cream and heat through . serve topped with remaining bacon , onions and cheese .	1
Season chicken on all sides with salt and ground black pepper.	season chicken on all sides with salt and ground black pepper .	1
Stir in any accumulated juices from the chicken into the skillet. Stir butter into mushroom mixture, stirring constantly until butter is completely melted and incorporated.	stir in any accumulated juices from the chicken into the skillet . stir butter into mushroom mixture , stirring constantly until butter is completely melted and incorporated .	1
Season with salt and pepper. Spoon mushroom sauce over chicken and serve.	season with salt and pepper . spoon mushroom sauce over chicken and serve .	1
Season with salt, black pepper, and cayenne pepper. Stir again and garnish with Parmesan cheese.	season with salt , black pepper , and cayenne pepper . stir again and garnish with parmesan cheese .	1
Strain chicken broth and set aside. Discard lemon grass, garlic, and ginger.	strain chicken broth and set aside . discard lemon grass , garlic , and ginger .	1
Stir in mushrooms and cook for 5 more minutes.	stir in mushrooms and cook for 5 more minutes .	1
Skim off any excess oil and fat that rises to the top and discard.	skim off any excess oil and fat that rises to the top and discard .	1
Remove from heat and add about 1/2 the cilantro.	remove from heat and add about 1/2 the cilantro .	1
Serve with plates of cilantro, lime wedges, and fresh sliced jalapenos.	serve with plates of cilantro , lime wedges , and fresh sliced jalapenos .	1
Trim bottoms of broccoli stems and cut off broccoli heads; cut the broccoli heads into quarters. Peel broccoli stems and cut into quarters crosswise.	trim bottoms of broccoli stems and cut off broccoli heads ; cut the broccoli heads into quarters . peel broccoli stems and cut into quarters crosswise .	1
Whisk together garlic, lemon juice, rice vinegar, Dijon mustard, red pepper flakes, salt, and black pepper together in a large serving bowl. Slowly drizzle in olive oil while whisking rapidly until the dressing is thick and creamy. Adjust salt, black pepper, and crushed red pepper flakes to taste.	whisk together garlic , lemon juice , rice vinegar , dijon mustard , red pepper flakes , salt , and black pepper together in a large serving bowl . slowly drizzle in olive oil while whisking rapidly until th e dressing is thick and creamy . adjust salt , black pepper , and crushed red pepper flakes to taste .	1
Combine bread crumbs and 1 teaspoon melted butter in a small bowl.	combine bread crumbs and 1 teaspoon melted butter in a small bowl .	1
Remove saucepan from heat and add 1/2 cup shredded Gruyere cheese, Dijon mustard, salt, black pepper, cayenne pepper, and nutmeg. Stir to combine.	remove saucepan from heat and add 1/2 cup shredded gruyere cheese , dijon mustard , salt , black pepper , cayenne pepper , and nutmeg . stir to combine .	1
Stir chicken and diced pickle into cheese sauce.	stir chicken and diced pickle into cheese sauce .	1
Place toasted bread slices on the prepared baking sheet. Brush one side of each bread slice  with 3/4 teaspoon melted butter. Turn slices over and top each with 1/4 of the cheese sauce. Sprinkle 1 tablespoon shredded Gruyere cheese over the top of each sandwich. Top with bread crumb mixture.	place toasted bread slices on the prepared baking sheet . brush one side of each bread slice with 3/4 teaspoon melted butter . turn slices over and top each with 1/4 of the cheese sauce . sprinkle 1 tab lespoon shredded gruyere cheese over the top of each sandwich . top with bread crumb mixture .	1
Mix sugar, flour, cinnamon, and nutmeg together.  Sprinkle over sliced tomatoes, coating them.  Pour into pastry lined dish.  Dot with butter or margarine.  Cover with second crust, fluting edges.  Cut three or four slits in top to allow steam to escape.	mix sugar , flour , cinnamon , and nutmeg together . sprinkle over sliced tomatoes , coating them . pour into pastry lined dish . dot with butter or margarine . cover with second crust , fluting edges . cu t three or four slits in top to allow steam to escape .	1
Mix the salt, basil, rosemary, garlic powder, mustard, paprika, black pepper, thyme, celery seed, parsley, cumin, cayenne pepper, and chicken bouillon together until blended.	mix the salt , basil , rosemary , garlic powder , mustard , paprika , black pepper , thyme , celery seed , parsley , cumin , cayenne pepper , and chicken bouillon together until blended .	1
Pour apple cider into sausage mixture; increase heat to medium-high and stir in potatoes. Bring to a simmer.	pour apple cider into sausage mixture ; increase heat to medium-high and stir in potatoes . bring to a simmer .	1
Return potatoes and sausages to the Dutch oven and remove from heat. Season with salt and pepper to taste. Garnish with mustard and parsley.	return potatoes and sausages to the dutch oven and remove from heat . season with salt and pepper to taste . garnish with mustard and parsley .	1
Pour the soup into a blender, filling the pitcher no more than halfway full. Hold down the lid of the blender with a folded kitchen towel, and carefully start the blender, using a few quick pulses to get the soup moving before leaving it on to puree. Puree in batches until smooth and pour into a clean pot. Alternately, you can use a stick blender and puree the soup right in the cooking pot.	pour the soup into a blender , filling the pitcher no more than halfway full . hold down the lid of the blender with a folded kitchen towel , and carefully start the blender , using a few quick pulses to get the soup moving before leaving it on to puree . puree in batches until smooth and pour into a clean pot . alternately , you can use a stick blender and puree the soup right in the cooking pot .	1
In small saucepan, over medium-heat melt 3 tablespoons butter, stir in flour and add milk.  Stir until thick and bubbly, and add to soup.  Season with pepper and serve.	in small saucepan , over medium-heat melt 3 tablespoons butter , stir in flour and add milk . stir until thick and bubbly , and add to soup . season with pepper and serve .	1
Stir Cheddar cheese into vegetable mixture until cheese melts. Season with salt and pepper to taste.	stir cheddar cheese into vegetable mixture until cheese melts . season with salt and pepper to taste .	1
Combine ground beef, Italian sausage, diced tomatoes, Italian parsley, garlic, salt, black pepper, and cayenne pepper into bowl with reserved onions; mix well. Stir in cooked rice and Parmigiano Reggiano. Stuff green bell peppers with beef and sausage mixture.	combine ground beef , italian sausage , diced tomatoes , italian parsley , garlic , salt , black pepper , and cayenne pepper into bowl with reserved onions ; mix well . stir in cooked rice and parmigiano reggi ano . stuff green bell peppers with beef and sausage mixture .	1
Sift flour, cocoa, baking soda, salt, and baking powder together in a large mixing bowl until combined.	sift flour , cocoa , baking soda , salt , and baking powder together in a large mixing bowl until combined .	1
Place butter and sugar into the work bowl of a large stand mixer fitted with a whisk attachment. Beat butter and sugar together until light and fluffy. Scrape down attachment and bowl. Add eggs into butter-sugar mixture, one at a time, mixing the first egg in thoroughly before adding the second. Scrape down sides of bowl as you work.	place butter and sugar into the work bowl of a large stand mixer fitted with a whisk attachment . beat butter and sugar together until light and fluffy . scrape down attachment and bowl . add eggs into b utter-sugar mixture , one at a time , mixing the first egg in thoroughly before adding the second . scrape down sides of bowl as you work .	1
Beat buttermilk and vinegar into moist ingredients, followed by vanilla extract and red food coloring. Mix until color is even.	beat buttermilk and vinegar into moist ingredients , followed by vanilla extract and red food coloring . mix until color is even .	1
Pour dry ingredients into wet ingredients and gently whisk by hand until batter is smooth. Spoon batter into prepared muffin cups, filling them about 3/4 full.	pour dry ingredients into wet ingredients and gently whisk by hand until batter is smooth . spoon batter into prepared muffin cups , filling them about 3/4 full .	1
Place basil, garlic, Parmesan, pine nuts, and tomato in a food processor. Gradually add olive oil, while pulsing, until mixture is smooth and creamy.	place basil , garlic , parmesan , pine nuts , and tomato in a food processor . gradually add olive oil , while pulsing , until mixture is smooth and creamy .	1
In a bowl, stir together chicken broth, 1 cup white wine, dried basil, oregano, and minced garlic. Stir in chicken pieces.	in a bowl , stir together chicken broth , 1 cup white wine , dried basil , oregano , and minced garlic . stir in chicken pieces .	1
Add pasta and pesto to the skillet. Stir in cream, and cook until the sauce is thickened. Adjust salt and freshly ground pepper to taste, and serve with freshly grated Parmesan.	add pasta and pesto to the skillet . stir in cream , and cook until the sauce is thickened . adjust salt and freshly ground pepper to taste , and serve with freshly grated parmesan .	1
Blend basil, 2 tablespoons basil water, Parmesan cheese, cream cheese, olive oil, butter, and garlic in a blender until smooth and creamy.	blend basil , 2 tablespoons basil water , parmesan cheese , cream cheese , olive oil , butter , and garlic in a blender until smooth and creamy .	1
