10 slices bacon	10 slices bacon	1
1 head fresh broccoli, cut into bite size pieces	1 head fresh broccoli , cut into bite size pieces	1
¼ cup red onion, chopped	1/4 cup red onion , chopped	1
½ cup raisins	1/2 cup raisins	1
3 tablespoons white wine vinegar	3 tablespoons white wine vinegar	2
2 tablespoons white sugar	2 tablespoons white sugar	3
1 cup mayonnaise	1 cup mayonnaise	7
1 cup sunflower seeds	1 cup sunflower seeds	1
2 heads fresh broccoli	2 heads fresh broccoli	1
1 red onion	1 red onion	1
½ pound bacon	1/2 pound bacon	2
¾ cup raisins	3/4 cup raisins	1
¾ cup sliced almonds	3/4 cup sliced almonds	1
½ cup white sugar	1/2 cup white sugar	7
2 tablespoons white wine vinegar	2 tablespoons white wine vinegar	1
4 skinless, boneless chicken breast halves - cooked and diced	4 skinless , boneless chicken breast halves - cooked and diced	1
1 stalk celery, diced	1 stalk celery , diced	1
4 green onions, chopped	4 green onions , chopped	3
1 Golden Delicious apple - peeled, cored and diced	1 golden delicious apple - peeled , cored and diced	1
⅓ cup golden raisins	1/3 cup golden raisins	1
⅓ cup seedless green grapes, halved	1/3 cup seedless green grapes , halved	1
½ cup chopped toasted pecans	1/2 cup chopped toasted pecans	1
⅛ teaspoon ground black pepper	⅛ teaspoon ground black pepper	2
½ teaspoon curry powder	1/2 teaspoon curry powder	1
¾ cup light mayonnaise	3/4 cup light mayonnaise	1
4 cups cubed, cooked chicken meat	4 cups cubed , cooked chicken meat	1
1 teaspoon paprika	1 teaspoon paprika	2
1 ½ cups dried cranberries	1 1/2 cups dried cranberries	1
1 cup chopped celery	1 cup chopped celery	3
2 green onions, chopped	2 green onions , chopped	1
½ cup minced green bell pepper	1/2 cup minced green bell pepper	1
1 cup chopped pecans	1 cup chopped pecans	2
1 teaspoon seasoning salt	1 teaspoon seasoning salt	1
ground black pepper to taste	ground black pepper to taste	2
¾ cup cashew halves	3/4 cup cashew halves	1
4 slices bacon, coarsely chopped	4 slices bacon , coarsely chopped	1
1 tablespoon melted butter	1 tablespoon melted butter	1
1 teaspoon chopped fresh rosemary	1 teaspoon chopped fresh rosemary	1
1 teaspoon curry powder	1 teaspoon curry powder	2
1 tablespoon brown sugar	1 tablespoon brown sugar	3
½ teaspoon kosher salt	1/2 teaspoon kosher salt	2
½ teaspoon cayenne pepper	1/2 teaspoon cayenne pepper	2
3 tablespoons Dijon mustard	3 tablespoons dijon mustard	3
2 tablespoons honey	2 tablespoons honey	1
½ cup olive oil	1/2 cup olive oil	2
salt and black pepper to taste	salt and black pepper to taste	2
1 (10 ounce) package mixed salad greens	1 -lrb- 10 ounce -rrb- package mixed salad greens	2
½ medium Bosc pear, thinly sliced	1/2 medium bosc pear , thinly sliced	1
½ cup halved seedless red grapes	1/2 cup halved seedless red grapes	1
2 pounds maple-flavored bacon	2 pounds maple-flavored bacon	1
1 large head fresh broccoli, chopped	1 large head fresh broccoli , chopped	1
¾ cup chopped celery	3/4 cup chopped celery	1
¼ cup minced green onions	1/4 cup minced green onions	1
¼ cup diced red onion	1/4 cup diced red onion	1
1 ½ cups seedless grapes, halved	1 1/2 cups seedless grapes , halved	1
¾ cup blanched slivered almonds	3/4 cup blanched slivered almonds	1
¼ cup white sugar	1/4 cup white sugar	5
2 tablespoons distilled white vinegar	2 tablespoons distilled white vinegar	1
2 skinless, boneless chicken breast halves	2 skinless , boneless chicken breast halves	2
1 tablespoon vegetable oil	1 tablespoon vegetable oil	1
1 (11 ounce) can Mexican-style corn	1 -lrb- 11 ounce -rrb- can mexican-style corn	1
½ cup salsa	1/2 cup salsa	2
1 onion, chopped	1 onion , chopped	7
1 tomato, cut into wedges	1 tomato , cut into wedges	1
6 eggs	6 eggs	1
2 pounds spinach, rinsed and chopped	2 pounds spinach , rinsed and chopped	1
2 ¾ ounces croutons	2 3/4 ounces croutons	1
¼ cup sliced fresh mushrooms	1/4 cup sliced fresh mushrooms	1
⅔ cup white sugar	2/3 cup white sugar	2
1 teaspoon salt	1 teaspoon salt	10
1 cup vegetable oil	1 cup vegetable oil	2
⅓ cup cider vinegar	1/3 cup cider vinegar	2
½ teaspoon ground black pepper	1/2 teaspoon ground black pepper	5
1 teaspoon celery seed	1 teaspoon celery seed	1
1 tablespoon prepared Dijon-style mustard	1 tablespoon prepared dijon-style mustard	1
½ cup white vinegar	1/2 cup white vinegar	1
2 tablespoons Worcestershire sauce	2 tablespoons worcestershire sauce	1
⅓ cup ketchup	1/3 cup ketchup	1
1 small onion, chopped	1 small onion , chopped	3
5 slices bacon	5 slices bacon	1
3 eggs	3 eggs	5
1 pound fresh spinach - rinsed, dried and torn into bite size pieces	1 pound fresh spinach - rinsed , dried and torn into bite size pieces	1
1 (4 ounce) can sliced water chestnuts, drained	1 -lrb- 4 ounce -rrb- can sliced water chestnuts , drained	1
2 cups water	2 cups water	4
2 cubes chicken bouillon	2 cubes chicken bouillon	1
1 clove garlic, smashed	1 clove garlic , smashed	1
1 cup uncooked quinoa	1 cup uncooked quinoa	1
2 large cooked chicken breasts - cut into bite size pieces	2 large cooked chicken breasts - cut into bite size pieces	1
1 large red onion, diced	1 large red onion , diced	1
1 large green bell pepper, diced	1 large green bell pepper , diced	1
½ cup chopped kalamata olives	1/2 cup chopped kalamata olives	1
½ cup crumbled feta cheese	1/2 cup crumbled feta cheese	3
¼ cup chopped fresh parsley	1/4 cup chopped fresh parsley	1
¼ cup chopped fresh chives	1/4 cup chopped fresh chives	1
½ teaspoon salt	1/2 teaspoon salt	14
⅔ cup fresh lemon juice	2/3 cup fresh lemon juice	1
1 tablespoon balsamic vinegar	1 tablespoon balsamic vinegar	2
¼ cup olive oil	1/4 cup olive oil	5
1 tablespoon olive oil	1 tablespoon olive oil	9
½ pound bacon, cut crosswise into 1-inch pieces	1/2 pound bacon , cut crosswise into 1 inch pieces	1
2 cloves garlic, minced	2 cloves garlic , minced	3
2 teaspoons lemon zest	2 teaspoons lemon zest	1
⅔ cup creme fraiche	2/3 cup creme fraiche	1
2 cups ditalini pasta	2 cups ditalini pasta	1
2 cups halved cherry tomatoes	2 cups halved cherry tomatoes	1
4 cups baby arugula, coarsely chopped	4 cups baby arugula , coarsely chopped	1
salt and ground black pepper to taste	salt and ground black pepper to taste	11
1 pinch cayenne pepper, or to taste	1 pinch cayenne pepper , or to taste	2
1 tablespoon freshly shredded Parmesan cheese, or to taste (optional)	1 tablespoon freshly shredded parmesan cheese , or to taste -lrb- optional -rrb-	1
½ cup light mayonnaise	1/2 cup light mayonnaise	1
½ cup low-fat sour cream	1/2 cup low-fat sour cream	1
¼ teaspoon paprika	1/4 teaspoon paprika	2
2 tablespoons prepared horseradish	2 tablespoons prepared horseradish	2
2 tablespoons chopped red onion	2 tablespoons chopped red onion	1
¼ cup real bacon bits	1/4 cup real bacon bits	1
salt and pepper to taste	salt and pepper to taste	12
½ pound ground pork sausage	1/2 pound ground pork sausage	1
12 eggs, beaten	12 eggs , beaten	1
½ (4 ounce) can chopped green chile peppers, drained	1/2 -lrb- 4 ounce -rrb- can chopped green chile peppers , drained	1
1 teaspoon garlic powder	1 teaspoon garlic powder	2
1 Granny Smith apple, cored and julienned	1 granny smith apple , cored and julienned	1
1 cup balsamic vinaigrette salad dressing	1 cup balsamic vinaigrette salad dressing	1
1 cup crumbled blue cheese	1 cup crumbled blue cheese	1
½ cup chopped pecans	1/2 cup chopped pecans	3
4 slices turkey bacon	4 slices turkey bacon	1
6 cups torn romaine lettuce	6 cups torn romaine lettuce	1
3 tablespoons butter	3 tablespoons butter	5
4 sweet onions, thinly sliced	4 sweet onions , thinly sliced	1
2 firm pears, peeled, quartered, and sliced	2 firm pears , peeled , quartered , and sliced	1
¾ cup crumbled blue cheese	3/4 cup crumbled blue cheese	1
1 pound bulk pork sausage	1 pound bulk pork sausage	1
1 pound ground beef	1 pound ground beef	2
1 large onion, diced	1 large onion , diced	1
4 cups water	4 cups water	1
1 (10 ounce) can diced tomatoes with green chile peppers (such as RO*TEL&reg;), undrained	1 -lrb- 10 ounce -rrb- can diced tomatoes with green chile peppers -lrb- such as ro * tel & reg ;-rrb- , undrained	1
1 teaspoon Worcestershire sauce	1 teaspoon worcestershire sauce	1
¾ teaspoon garlic salt	3/4 teaspoon garlic salt	1
1 (4 ounce) can chopped green chilies	1 -lrb- 4 ounce -rrb- can chopped green chilies	1
4 teaspoons molasses	4 teaspoons molasses	1
4 beef bouillon cubes	4 beef bouillon cubes	1
¼ teaspoon ground black pepper	1/4 teaspoon ground black pepper	6
¼ teaspoon ground cumin	1/4 teaspoon ground cumin	1
4 tablespoons lemon juice	4 tablespoons lemon juice	1
4 tablespoons olive oil	4 tablespoons olive oil	1
2 tablespoons coarse grained prepared mustard	2 tablespoons coarse grained prepared mustard	1
9 baking potatoes	9 baking potatoes	1
⅔ cup butter	2/3 cup butter	1
⅔ cup all-purpose flour	2/3 cup all-purpose flour	2
6 cups whole milk	6 cups whole milk	1
½ tablespoon salt	1/2 tablespoon salt	1
1 teaspoon ground black pepper	1 teaspoon ground black pepper	4
½ cup bacon bits, divided	1/2 cup bacon bits , divided	1
10 ounces shredded Cheddar cheese	10 ounces shredded cheddar cheese	1
1 (8 ounce) container sour cream	1 -lrb- 8 ounce -rrb- container sour cream	1
⅓ cup brown sugar	1/3 cup brown sugar	1
1 teaspoon ground cinnamon	1 teaspoon ground cinnamon	4
½ cup butter, softened	1/2 cup butter , softened	2
2 eggs	2 eggs	6
1 ½ teaspoons vanilla extract	1 1/2 teaspoons vanilla extract	1
1 ½ cups all-purpose flour	1 1/2 cups all-purpose flour	2
1 ¾ teaspoons baking powder	1 3/4 teaspoons baking powder	1
½ cup milk	1/2 cup milk	4
1 apple, peeled and chopped	1 apple , peeled and chopped	1
2 prepared pie crusts	2 prepared pie crusts	1
4 cups peeled and sliced apples	4 cups peeled and sliced apples	1
2 cups cranberries	2 cups cranberries	1
¾ cup white sugar	3/4 cup white sugar	5
1 tablespoon cornstarch	1 tablespoon cornstarch	1
2 tablespoons butter, cut into small pieces	2 tablespoons butter , cut into small pieces	1
1 pound sweet Italian sausage, casings removed	1 pound sweet italian sausage , casings removed	1
¼ cup butter	1/4 cup butter	6
6 cups coarsely chopped leeks	6 cups coarsely chopped leeks	1
3 tart apples - peeled, cored and chopped	3 tart apples - peeled , cored and chopped	1
2 cups chopped celery	2 cups chopped celery	1
4 teaspoons poultry seasoning	4 teaspoons poultry seasoning	1
2 teaspoons dried rosemary, crushed	2 teaspoons dried rosemary , crushed	1
1 cup dried cranberries	1 cup dried cranberries	1
12 cups white bread cubes, baked until slightly dry	12 cups white bread cubes , baked until slightly dry	1
1 ⅓ cups chicken stock	1 1/3 cups chicken stock	1
1 pound bacon, chopped	1 pound bacon , chopped	1
2 medium green bell peppers, chopped	2 medium green bell peppers , chopped	1
¼ teaspoon pepper	1/4 teaspoon pepper	1
2 tablespoons fresh lemon juice	2 tablespoons fresh lemon juice	1
1 ½ pounds small new potatoes, unpeeled	1 1/2 pounds small new potatoes , unpeeled	1
2 teaspoons corn oil	2 teaspoons corn oil	1
1 skinless, boneless chicken breast half - cut into bite-size pieces	1 skinless , boneless chicken breast half - cut into bite-size pieces	1
½ teaspoon garlic powder	1/2 teaspoon garlic powder	2
1 ½ tablespoons mayonnaise	1 1/2 tablespoons mayonnaise	1
½ lime, juiced	1/2 lime , juiced	1
½ teaspoon ground ginger	1/2 teaspoon ground ginger	2
2 teaspoons milk	2 teaspoons milk	1
2 cups fresh spinach, stems removed	2 cups fresh spinach , stems removed	1
4 fresh strawberries, sliced	4 fresh strawberries , sliced	1
1 ½ tablespoons slivered almonds	1 1/2 tablespoons slivered almonds	1
freshly ground black pepper to taste	freshly ground black pepper to taste	3
1 pound ground pork sausage	1 pound ground pork sausage	1
1 teaspoon mustard powder	1 teaspoon mustard powder	1
4 eggs, beaten	4 eggs , beaten	2
2 cups milk	2 cups milk	5
6 slices white bread, toasted and cut into cubes	6 slices white bread , toasted and cut into cubes	1
8 ounces mild Cheddar cheese, shredded	8 ounces mild cheddar cheese , shredded	1
8 ounces bacon	8 ounces bacon	1
8 ounces broccoli, cut into florets	8 ounces broccoli , cut into florets	1
8 slices bread	8 slices bread	1
2 tablespoons butter, softened	2 tablespoons butter , softened	2
¾ cup shredded Cheddar cheese	3/4 cup shredded cheddar cheese	1
12 eggs	12 eggs	1
½ teaspoon dry mustard	1/2 teaspoon dry mustard	1
8 medium red potatoes	8 medium red potatoes	1
4 eggs	4 eggs	2
8 slices bacon	8 slices bacon	1
3 green onions, diced	3 green onions , diced	1
3 fresh jalapeno peppers, diced	3 fresh jalapeno peppers , diced	1
½ green bell pepper, diced	1/2 green bell pepper , diced	1
2 ½ cups mayonnaise	2 1/2 cups mayonnaise	1
2 tablespoons brown mustard	2 tablespoons brown mustard	1
1 teaspoon Cajun seasoning	1 teaspoon cajun seasoning	1
1 (8 ounce) package PHILADELPHIA Cream Cheese, softened	1 -lrb- 8 ounce -rrb- package philadelphia cream cheese , softened	1
1 (6 ounce) package OSCAR MAYER Deli Fresh Oven Roasted Chicken Breast Cuts	1 -lrb- 6 ounce -rrb- package oscar mayer deli fresh oven roasted chicken breast cuts	1
½ cup hot pepper sauce for Buffalo wings	1/2 cup hot pepper sauce for buffalo wings	1
¼ cup KRAFT Natural Blue Cheese Crumbles	1/4 cup kraft natural blue cheese crumbles	1
2 green onions, sliced	2 green onions , sliced	1
1 large onion, chopped	1 large onion , chopped	2
3 cloves garlic, peeled and chopped	3 cloves garlic , peeled and chopped	1
2 (10 ounce) packages chopped frozen broccoli, thawed	2 -lrb- 10 ounce -rrb- packages chopped frozen broccoli , thawed	2
1 potato, peeled and chopped	1 potato , peeled and chopped	1
4 cups chicken broth	4 cups chicken broth	1
¼ teaspoon ground nutmeg	1/4 teaspoon ground nutmeg	3
1 cup uncooked long grain white rice	1 cup uncooked long grain white rice	1
1 onion, diced	1 onion , diced	3
2 cups marinara sauce	2 cups marinara sauce	1
1 cup beef broth	1 cup beef broth	1
¼ teaspoon crushed red pepper flakes	1/4 teaspoon crushed red pepper flakes	1
1 pound lean ground beef	1 pound lean ground beef	1
¼ pound hot Italian pork sausage, casing removed	1/4 pound hot italian pork sausage , casing removed	1
1 (10 ounce) can diced tomatoes	1 -lrb- 10 ounce -rrb- can diced tomatoes	1
¼ cup chopped fresh Italian parsley	1/4 cup chopped fresh italian parsley	1
4 cloves garlic, minced	4 cloves garlic , minced	1
2 teaspoons salt	2 teaspoons salt	2
1 teaspoon freshly ground black pepper	1 teaspoon freshly ground black pepper	1
1 pinch ground cayenne pepper	1 pinch ground cayenne pepper	1
4 large green bell peppers, halved lengthwise and seeded	4 large green bell peppers , halved lengthwise and seeded	1
1 cup finely grated Parmigiano-Reggiano cheese, plus more for topping	1 cup finely grated parmigiano-reggiano cheese , plus more for topping	1
1 ¼ cups all-purpose flour	1 1/4 cups all-purpose flour	1
½ cup butter, cut into chunks	1/2 cup butter , cut into chunks	1
2 tablespoons sour cream	2 tablespoons sour cream	1
4 fresh peaches - peeled, pitted, and sliced	4 fresh peaches - peeled , pitted , and sliced	1
3 egg yolks	3 egg yolks	1
2 tablespoons all-purpose flour	2 tablespoons all-purpose flour	4
⅓ cup sour cream	1/3 cup sour cream	1
1 cup white sugar	1 cup white sugar	5
¾ cup buttermilk	3/4 cup buttermilk	2
¾ cup vegetable oil	3/4 cup vegetable oil	1
1 ½ cups white sugar	1 1/2 cups white sugar	1
2 teaspoons vanilla extract	2 teaspoons vanilla extract	3
2 teaspoons ground cinnamon	2 teaspoons ground cinnamon	1
¼ teaspoon salt	1/4 teaspoon salt	10
2 cups all-purpose flour	2 cups all-purpose flour	2
2 teaspoons baking soda	2 teaspoons baking soda	1
2 cups shredded carrots	2 cups shredded carrots	1
1 cup flaked coconut	1 cup flaked coconut	1
1 cup chopped walnuts	1 cup chopped walnuts	1
1 (8 ounce) can crushed pineapple with juice	1 -lrb- 8 ounce -rrb- can crushed pineapple with juice	1
1 cup raisins	1 cup raisins	1
1 cup whole wheat flour	1 cup whole wheat flour	1
⅓ cup wheat germ	1/3 cup wheat germ	1
1 ½ teaspoons baking powder	1 1/2 teaspoons baking powder	1
½ teaspoon baking soda	1/2 teaspoon baking soda	2
2 tablespoons brown sugar	2 tablespoons brown sugar	1
5 ⅓ tablespoons unsalted butter	5 1/3 tablespoons unsalted butter	1
2 ½ cups buttermilk	2 1/2 cups buttermilk	1
2 eggs, beaten	2 eggs , beaten	3
3 tablespoons unsalted butter	3 tablespoons unsalted butter	1
1 teaspoon extra-virgin olive oil, or to taste	1 teaspoon extra-virgin olive oil , or to taste	1
1 cup quinoa, rinsed	1 cup quinoa , rinsed	1
2 cups chicken broth	2 cups chicken broth	1
2 cups chopped cooked chicken	2 cups chopped cooked chicken	1
12 grape tomatoes, quartered	12 grape tomatoes , quartered	1
¼ cup finely chopped fresh basil	1/4 cup finely chopped fresh basil	1
¼ cup grated Parmesan cheese	1/4 cup grated parmesan cheese	2
1 clove garlic, minced	1 clove garlic , minced	4
¼ cup extra-virgin olive oil	1/4 cup extra-virgin olive oil	1
¼ teaspoon red pepper flakes	1/4 teaspoon red pepper flakes	1
1 ¾ cups water	1 3/4 cups water	1
1 cup quinoa	1 cup quinoa	1
¾ cup dried cranberries	3/4 cup dried cranberries	2
1 cup bite-size broccoli pieces	1 cup bite-size broccoli pieces	1
2 tablespoons olive oil	2 tablespoons olive oil	4
1 tablespoon orange juice	1 tablespoon orange juice	1
1 tablespoon lime juice	1 tablespoon lime juice	1
½ cup chopped walnuts	1/2 cup chopped walnuts	1
1 head fresh broccoli, chopped	1 head fresh broccoli , chopped	1
1 cup shredded Cheddar cheese	1 cup shredded cheddar cheese	2
¾ cup all-purpose flour	3/4 cup all-purpose flour	1
¼ teaspoon dry mustard	1/4 teaspoon dry mustard	1
¼ cup butter, melted	1/4 cup butter , melted	1
1 tablespoon butter	1 tablespoon butter	7
¼ pound fresh mushrooms, sliced	1/4 pound fresh mushrooms , sliced	1
1 cup half-and-half cream	1 cup half-and-half cream	1
3 eggs, beaten	3 eggs , beaten	2
1 whole roasting chicken, cut in quarters	1 whole roasting chicken , cut in quarters	1
1 large onion, sliced	1 large onion , sliced	1
8 ounces fresh mushrooms, quartered	8 ounces fresh mushrooms , quartered	1
1 pinch salt	1 pinch salt	3
1 pinch ground black pepper	1 pinch ground black pepper	2
4 cloves garlic, sliced	4 cloves garlic , sliced	1
3 sprigs rosemary	3 sprigs rosemary	1
1 teaspoon dried oregano	1 teaspoon dried oregano	3
½ teaspoon red pepper flakes, or to taste	1/2 teaspoon red pepper flakes , or to taste	1
1 cup tomato sauce	1 cup tomato sauce	1
½ cup water	1/2 cup water	3
2 red bell peppers, sliced	2 red bell peppers , sliced	1
2 green bell peppers, sliced	2 green bell peppers , sliced	1
1 cup uncooked elbow macaroni	1 cup uncooked elbow macaroni	1
1 stalk celery, chopped	1 stalk celery , chopped	3
¼ cup mayonnaise	1/4 cup mayonnaise	1
¼ cup sour cream	1/4 cup sour cream	2
2 tablespoons milk	2 tablespoons milk	1
1 (10 ounce) can chicken chunks, drained	1 -lrb- 10 ounce -rrb- can chicken chunks , drained	1
1 (1 ounce) package dry Ranch-style dressing mix	1 -lrb- 1 ounce -rrb- package dry ranch-style dressing mix	1
2 teaspoons paprika	2 teaspoons paprika	1
1 tablespoon olive oil, or as needed	1 tablespoon olive oil , or as needed	1
1 skinless, boneless chicken breast half, cut into cubes	1 skinless , boneless chicken breast half , cut into cubes	1
1 large sweet potato, peeled and cut into 1/2-inch pieces	1 large sweet potato , peeled and cut into 1/2-inch pieces	1
1 tablespoon Irish whiskey	1 tablespoon irish whiskey	1
1 tablespoon minced fresh sage	1 tablespoon minced fresh sage	1
1 pear - peeled, cored, and cut into 1/2-inch pieces	1 pear - peeled , cored , and cut into 1/2-inch pieces	1
2 cups baby spinach	2 cups baby spinach	1
¼ cup chopped toasted hazelnuts	1/4 cup chopped toasted hazelnuts	1
2 (1 1/2 pound) pork tenderloin, trimmed of silver skin	2 -lrb- 1 1/2 pound -rrb- pork tenderloin , trimmed of silver skin	1
½ onion, chopped	1/2 onion , chopped	4
⅓ cup fresh thyme leaves	1/3 cup fresh thyme leaves	1
¼ cup white vinegar	1/4 cup white vinegar	1
4 cloves garlic	4 cloves garlic	1
2 habanero peppers, seeded, or more to taste	2 habanero peppers , seeded , or more to taste	1
2 tablespoons minced fresh ginger	2 tablespoons minced fresh ginger	1
2 tablespoons soy sauce	2 tablespoons soy sauce	2
2 tablespoons vegetable oil	2 tablespoons vegetable oil	1
2 teaspoons ground allspice	2 teaspoons ground allspice	1
¼ teaspoon cayenne pepper	1/4 teaspoon cayenne pepper	3
¼ teaspoon ground cinnamon	1/4 teaspoon ground cinnamon	1
1 bunch asparagus, trimmed and cut into 1/2-inch pieces	1 bunch asparagus , trimmed and cut into 1/2-inch pieces	1
2 tablespoons unsalted butter	2 tablespoons unsalted butter	1
1 cup cold milk	1 cup cold milk	1
1 teaspoon kosher salt	1 teaspoon kosher salt	1
½ clove garlic, minced	1/2 clove garlic , minced	1
4 eggs, separated	4 eggs , separated	1
½ cup grated sharp white Cheddar cheese	1/2 cup grated sharp white cheddar cheese	1
½ pound uncooked orzo pasta	1/2 pound uncooked orzo pasta	1
⅓ cup red wine vinegar	1/3 cup red wine vinegar	1
1 teaspoon Dijon mustard	1 teaspoon dijon mustard	1
¾ teaspoon garlic powder	3/4 teaspoon garlic powder	1
¾ teaspoon dried oregano	3/4 teaspoon dried oregano	1
¾ teaspoon dried basil	3/4 teaspoon dried basil	1
¾ teaspoon onion powder	3/4 teaspoon onion powder	1
½ cup grape tomatoes, cut in half	1/2 cup grape tomatoes , cut in half	1
¼ cup black olives, cut in half lengthwise	1/4 cup black olives , cut in half lengthwise	1
2 ounces crumbled feta cheese	2 ounces crumbled feta cheese	1
1 grilled chicken breast half, diced	1 grilled chicken breast half , diced	1
2 red bell peppers, cut in half lengthwise and seeded	2 red bell peppers , cut in half lengthwise and seeded	1
4 sprigs fresh oregano	4 sprigs fresh oregano	1
2 cups orzo pasta	2 cups orzo pasta	1
2 (10 ounce) packages baby spinach	2 -lrb- 10 ounce -rrb- packages baby spinach	1
3 cups chopped grilled chicken	3 cups chopped grilled chicken	1
2 roma tomatoes, diced	2 roma tomatoes , diced	1
½ cup pine nuts	1/2 cup pine nuts	1
¼ cup chopped sun-dried tomatoes	1/4 cup chopped sun-dried tomatoes	1
2 tablespoons capers, or to taste (optional)	2 tablespoons capers , or to taste -lrb- optional -rrb-	1
1 cup balsamic vinegar	1 cup balsamic vinegar	1
⅓ cup olive oil	1/3 cup olive oil	1
2 tablespoons dried parsley	2 tablespoons dried parsley	1
2 teaspoons dried basil	2 teaspoons dried basil	1
2 cloves garlic, pressed	2 cloves garlic , pressed	1
¼ cup freshly grated Parmesan cheese, or to taste	1/4 cup freshly grated parmesan cheese , or to taste	1
2 chicken breast halves, boneless, skin-on	2 chicken breast halves , boneless , skin-on	1
8 ounces fresh mushrooms, sliced 1/4 inch thick	8 ounces fresh mushrooms , sliced 1/4 inch thick	1
2 tablespoons butter	2 tablespoons butter	7
2 onions, chopped	2 onions , chopped	1
5 cups chicken broth	5 cups chicken broth	2
2 potatoes, peeled and chopped	2 potatoes , peeled and chopped	1
2 carrots, peeled and thinly sliced	2 carrots , peeled and thinly sliced	1
8 cups chopped zucchini	8 cups chopped zucchini	1
2 tablespoons chopped fresh basil	2 tablespoons chopped fresh basil	1
1 pound baby carrots	1 pound baby carrots	1
water to cover	water to cover	2
2 ½ tablespoons honey	2 1/2 tablespoons honey	1
1 tablespoon lemon juice	1 tablespoon lemon juice	3
⅛ teaspoon ground ginger	⅛ teaspoon ground ginger	1
1 ½ pounds carrots, peeled and diagonally cut into 1/2-inch-wide pieces	1 1/2 pounds carrots , peeled and diagonally cut into 1/2-inch-wide pieces	1
1 tablespoon unsalted butter	1 tablespoon unsalted butter	1
1 tablespoon apple cider vinegar	1 tablespoon apple cider vinegar	1
2 tablespoons chopped fresh dill	2 tablespoons chopped fresh dill	1
½ teaspoon honey	1/2 teaspoon honey	1
½ cup butter	1/2 cup butter	2
1 egg	1 egg	3
1 cup sour cream	1 cup sour cream	5
1 teaspoon vanilla extract	1 teaspoon vanilla extract	5
3 cups all-purpose flour	3 cups all-purpose flour	2
1 teaspoon baking soda	1 teaspoon baking soda	2
1 teaspoon baking powder	1 teaspoon baking powder	4
2 (8 ounce) packages cream cheese, softened	2 -lrb- 8 ounce -rrb- packages cream cheese , softened	1
½ cup brown sugar	1/2 cup brown sugar	2
⅓ cup all-purpose flour	1/3 cup all-purpose flour	1
⅓ cup butter	1/3 cup butter	2
1 ¼ cups warm water (110 degrees F/45 degrees C)	1 1/4 cups warm water -lrb- 110 degrees f/45 degrees c -rrb-	1
3 cups bread flour	3 cups bread flour	1
2 tablespoons dry milk powder	2 tablespoons dry milk powder	1
1 ½ teaspoons salt	1 1/2 teaspoons salt	1
3 tablespoons grated Parmesan cheese	3 tablespoons grated parmesan cheese	2
1 ½ teaspoons dried marjoram	1 1/2 teaspoons dried marjoram	1
1 ½ teaspoons dried thyme	1 1/2 teaspoons dried thyme	1
1 teaspoon dried basil	1 teaspoon dried basil	1
1 tablespoon active dry yeast	1 tablespoon active dry yeast	1
1 cup water	1 cup water	1
½ cup red quinoa	1/2 cup red quinoa	1
2 avocados, peeled and mashed	2 avocados , peeled and mashed	1
2 tablespoons chopped fresh cilantro	2 tablespoons chopped fresh cilantro	1
1 tablespoon fresh lime juice	1 tablespoon fresh lime juice	2
1 pound cubed cooked chicken, chilled	1 pound cubed cooked chicken , chilled	1
2 tomatoes, seeded and chopped	2 tomatoes , seeded and chopped	1
2 tablespoons chopped scallions	2 tablespoons chopped scallions	1
8 ounces whole wheat penne pasta	8 ounces whole wheat penne pasta	1
2 tablespoons extra virgin olive oil	2 tablespoons extra virgin olive oil	1
1 (1 pound) beef rib eye steak	1 -lrb- 1 pound -rrb- beef rib eye steak	1
1 teaspoon minced garlic	1 teaspoon minced garlic	1
¼ cup chopped shallots	1/4 cup chopped shallots	1
1 tablespoon soy sauce	1 tablespoon soy sauce	1
½ cup sun-dried tomato pesto	1/2 cup sun-dried tomato pesto	1
½ cup sliced black olives	1/2 cup sliced black olives	1
1 cup chopped fresh spinach	1 cup chopped fresh spinach	1
1 teaspoon basil	1 teaspoon basil	1
1 tablespoon chopped parsley	1 tablespoon chopped parsley	1
3 tablespoons sunflower kernels	3 tablespoons sunflower kernels	1
2 large boneless, skinless chicken breasts	2 large boneless , skinless chicken breasts	1
1 ½ cups quinoa	1 1/2 cups quinoa	1
1 tablespoon chicken bouillon granules	1 tablespoon chicken bouillon granules	1
1 small butternut squash, peeled and cut into 1/2-inch dice	1 small butternut squash , peeled and cut into 1/2-inch dice	1
1 cup sweetened dried cranberries (such as Craisins&reg;)	1 cup sweetened dried cranberries -lrb- such as craisins & reg ;-rrb-	1
2 tablespoons fresh parsley, or more to taste	2 tablespoons fresh parsley , or more to taste	1
1 cup seashell pasta	1 cup seashell pasta	1
1 cup chopped, cooked chicken meat	1 cup chopped , cooked chicken meat	1
3 green onions, chopped into 1 inch pieces	3 green onions , chopped into 1 inch pieces	1
1 red bell pepper, chopped	1 red bell pepper , chopped	1
1 cup sliced black olives	1 cup sliced black olives	1
1 cucumber, peeled and chopped	1 cucumber , peeled and chopped	1
⅔ cup Italian-style salad dressing	2/3 cup italian-style salad dressing	1
¼ cup sunflower seeds (optional)	1/4 cup sunflower seeds -lrb- optional -rrb-	1
½ cup mayonnaise	1/2 cup mayonnaise	2
1 (10 ounce) package frozen chopped spinach, thawed and drained	1 -lrb- 10 ounce -rrb- package frozen chopped spinach , thawed and drained	1
2 cloves garlic, chopped	2 cloves garlic , chopped	1
4 skinless, boneless chicken breasts	4 skinless , boneless chicken breasts	2
4 slices bacon	4 slices bacon	1
6 slices bacon	6 slices bacon	3
⅓ cup apple cider vinegar	1/3 cup apple cider vinegar	1
½ red onion, coarsely chopped	1/2 red onion , coarsely chopped	1
½ teaspoon dry mustard powder	1/2 teaspoon dry mustard powder	1
½ cup vegetable oil	1/2 cup vegetable oil	1
1 teaspoon poppy seeds	1 teaspoon poppy seeds	1
10 cups torn romaine lettuce leaves	10 cups torn romaine lettuce leaves	1
1 (10 ounce) can mandarin orange segments, drained	1 -lrb- 10 ounce -rrb- can mandarin orange segments , drained	1
¼ cup toasted slivered almonds	1/4 cup toasted slivered almonds	1
2 cooked chicken breast halves, diced	2 cooked chicken breast halves , diced	1
1 ripe avocado, sliced	1 ripe avocado , sliced	1
½ cup sour cream	1/2 cup sour cream	2
1 ½ teaspoons ground black pepper	1 1/2 teaspoons ground black pepper	1
1 teaspoon lime juice	1 teaspoon lime juice	1
½ teaspoon onion powder	1/2 teaspoon onion powder	1
¼ cup pineapple juice	1/4 cup pineapple juice	1
3 tablespoons red wine vinegar	3 tablespoons red wine vinegar	1
salt to taste	salt to taste	3
1 (10 ounce) package chopped romaine lettuce	1 -lrb- 10 ounce -rrb- package chopped romaine lettuce	1
1 cup diced fresh pineapple	1 cup diced fresh pineapple	1
½ cup chopped and toasted macadamia nuts	1/2 cup chopped and toasted macadamia nuts	1
3 green onions, chopped	3 green onions , chopped	1
¼ cup flaked coconut, toasted	1/4 cup flaked coconut , toasted	1
4 slices bacon, chopped	4 slices bacon , chopped	1
2 avocados - peeled, pitted, and cubed	2 avocados - peeled , pitted , and cubed	1
3 green onions, finely chopped	3 green onions , finely chopped	1
red leaf lettuce	red leaf lettuce	1
1 cup shredded sharp Cheddar cheese	1 cup shredded sharp cheddar cheese	1
½ teaspoon garlic salt	1/2 teaspoon garlic salt	1
½ teaspoon seasoned salt	1/2 teaspoon seasoned salt	1
1 ½ teaspoons lemon juice	1 1/2 teaspoons lemon juice	1
12 buttery round crackers, crushed fine	12 buttery round crackers , crushed fine	1
2 slices bacon	2 slices bacon	2
1 tablespoon bacon drippings	1 tablespoon bacon drippings	1
1 cup chopped onion	1 cup chopped onion	1
½ cup diced celery	1/2 cup diced celery	1
½ cup diced green bell pepper	1/2 cup diced green bell pepper	1
½ cup diced red bell pepper	1/2 cup diced red bell pepper	1
1 tablespoon minced fresh thyme	1 tablespoon minced fresh thyme	1
¼ cup minced fresh parsley	1/4 cup minced fresh parsley	1
1 pinch Creole seasoning, or to taste	1 pinch creole seasoning , or to taste	1
5 cloves garlic, minced	5 cloves garlic , minced	1
½ cup beef broth	1/2 cup beef broth	1
2 (6 ounce) packages frozen peas, thawed	2 -lrb- 6 ounce -rrb- packages frozen peas , thawed	1
1 pound cooked bacon, chopped	1 pound cooked bacon , chopped	1
1 cup golden raisins	1 cup golden raisins	1
1 (8 ounce) package shredded Cheddar cheese	1 -lrb- 8 ounce -rrb- package shredded cheddar cheese	1
1 sweet onion, chopped	1 sweet onion , chopped	1
½ cup sunflower seeds	1/2 cup sunflower seeds	1
2 tablespoons wine vinegar	2 tablespoons wine vinegar	1
¼ teaspoon white sugar, or to taste	1/4 teaspoon white sugar , or to taste	1
1 pound skinless, boneless chicken breast halves - cut into 1 inch cubes	1 pound skinless , boneless chicken breast halves - cut into 1 inch cubes	1
1 pound andouille sausage, sliced	1 pound andouille sausage , sliced	1
1 large green bell pepper, chopped	1 large green bell pepper , chopped	1
1 cup chicken broth	1 cup chicken broth	1
2 teaspoons dried oregano	2 teaspoons dried oregano	2
2 teaspoons dried parsley	2 teaspoons dried parsley	1
2 teaspoons Cajun seasoning	2 teaspoons cajun seasoning	1
1 teaspoon cayenne pepper	1 teaspoon cayenne pepper	1
½ teaspoon dried thyme	1/2 teaspoon dried thyme	1
1 pound frozen cooked shrimp without tails	1 pound frozen cooked shrimp without tails	1
1 ¾ pounds diced chicken breast meat	1 3/4 pounds diced chicken breast meat	1
2 green bell peppers, diced	2 green bell peppers , diced	1
2 red bell peppers, diced	2 red bell peppers , diced	1
½ cup frozen corn kernels	1/2 cup frozen corn kernels	1
2 teaspoons chili powder	2 teaspoons chili powder	1
1 tablespoon dried parsley	1 tablespoon dried parsley	2
½ teaspoon ground cayenne pepper	1/2 teaspoon ground cayenne pepper	1
½ teaspoon ground cumin	1/2 teaspoon ground cumin	2
4 pounds pork baby back ribs	4 pounds pork baby back ribs	1
2 cups ketchup	2 cups ketchup	1
1 cup chili sauce	1 cup chili sauce	1
½ cup packed brown sugar	1/2 cup packed brown sugar	3
4 tablespoons vinegar	4 tablespoons vinegar	1
2 teaspoons Worcestershire sauce	2 teaspoons worcestershire sauce	1
1 dash hot sauce	1 dash hot sauce	1
1 bunch fresh asparagus, trimmed	1 bunch fresh asparagus , trimmed	1
1 tablespoon extra-virgin olive oil	1 tablespoon extra-virgin olive oil	1
2 ounces minced prosciutto	2 ounces minced prosciutto	1
ground black pepper	ground black pepper	1
1 teaspoon distilled white vinegar	1 teaspoon distilled white vinegar	1
½ lemon, zested and juiced	1/2 lemon , zested and juiced	1
¾ teaspoon salt	3/4 teaspoon salt	1
¼ teaspoon black pepper	1/4 teaspoon black pepper	1
⅛ teaspoon paprika	⅛ teaspoon paprika	1
¼ teaspoon garlic powder	1/4 teaspoon garlic powder	1
⅛ teaspoon onion powder	⅛ teaspoon onion powder	1
¼ teaspoon dried thyme	1/4 teaspoon dried thyme	1
¼ teaspoon dried parsley	1/4 teaspoon dried parsley	1
4 boneless, skinless chicken breast halves	4 boneless , skinless chicken breast halves	1
2 teaspoons garlic powder	2 teaspoons garlic powder	1
3 tablespoons lime juice	3 tablespoons lime juice	1
1 ½ pounds fresh broccoli, cut into bite size pieces	1 1/2 pounds fresh broccoli , cut into bite size pieces	1
3 tablespoons soy sauce	3 tablespoons soy sauce	1
2 teaspoons white vinegar	2 teaspoons white vinegar	2
⅓ cup chopped salted cashews	1/3 cup chopped salted cashews	1
4 slices thick-cut bacon, sliced into 1/4-inch strips, or more to taste	4 slices thick-cut bacon , sliced into 1/4-inch strips , or more to taste	1
1 pound Brussels sprouts, trimmed and halved, or more to taste	1 pound brussels sprouts , trimmed and halved , or more to taste	1
1 clove garlic, thinly sliced, or more to taste	1 clove garlic , thinly sliced , or more to taste	1
½ cup chicken stock, or more as needed	1/2 cup chicken stock , or more as needed	1
1 tablespoon butter, or to taste	1 tablespoon butter , or to taste	1
1 tablespoon balsamic vinegar, or more to taste	1 tablespoon balsamic vinegar , or more to taste	1
4 pounds Brussels sprouts, trimmed and thinly sliced	4 pounds brussels sprouts , trimmed and thinly sliced	1
6 slices bacon, chopped	6 slices bacon , chopped	1
⅓ cup sliced almonds	1/3 cup sliced almonds	1
2 tablespoons minced garlic	2 tablespoons minced garlic	1
2 tablespoons red wine vinegar	2 tablespoons red wine vinegar	1
⅓ cup plain bread crumbs	1/3 cup plain bread crumbs	1
1 pound ground pork	1 pound ground pork	1
¼ bunch fresh parsley, chopped	1/4 bunch fresh parsley , chopped	1
3 cloves garlic, crushed	3 cloves garlic , crushed	1
½ teaspoon red pepper flakes	1/2 teaspoon red pepper flakes	1
1 teaspoon dried Italian herb seasoning	1 teaspoon dried italian herb seasoning	1
2 tablespoons grated Parmesan cheese	2 tablespoons grated parmesan cheese	1
1 (3 to 3 1/2 pound) whole chicken	1 -lrb- 3 to 3 1/2 pound -rrb- whole chicken	1
2 ½ quarts cold water	2 1/2 quarts cold water	1
1 large carrot, cubed	1 large carrot , cubed	1
3 sprigs fresh thyme	3 sprigs fresh thyme	1
1 bay leaf	1 bay leaf	2
2 tablespoons all-purpose flour, or as needed	2 tablespoons all-purpose flour , or as needed	1
salt and freshly ground black pepper to taste	salt and freshly ground black pepper to taste	1
½ teaspoon cayenne pepper, or more to taste	1/2 teaspoon cayenne pepper , or more to taste	1
½ cup creme fraiche	1/2 cup creme fraiche	1
2 teaspoons chopped fresh thyme leaves	2 teaspoons chopped fresh thyme leaves	1
2 cups self-rising flour	2 cups self-rising flour	1
4 sprigs thyme, for garnish	4 sprigs thyme , for garnish	1
3 cups chicken broth	3 cups chicken broth	1
8 cups broccoli florets	8 cups broccoli florets	1
3 tablespoons all-purpose flour	3 tablespoons all-purpose flour	1
¼ cup melted butter	1/4 cup melted butter	1
¼ cup flour	1/4 cup flour	1
2 cups chicken stock	2 cups chicken stock	1
1 ½ cups coarsely chopped broccoli florets	1 1/2 cups coarsely chopped broccoli florets	1
1 cup matchstick-cut carrots	1 cup matchstick-cut carrots	1
1 stalk celery, thinly sliced	1 stalk celery , thinly sliced	1
2 ½ cups shredded sharp Cheddar cheese	2 1/2 cups shredded sharp cheddar cheese	1
4 cups chopped rhubarb	4 cups chopped rhubarb	1
1 ⅓ cups white sugar	1 1/3 cups white sugar	1
6 tablespoons all-purpose flour	6 tablespoons all-purpose flour	1
1 recipe pastry for a 9 inch double crust pie	1 recipe pastry for a 9 inch double crust pie	2
¾ cup butter	3/4 cup butter	2
¾ cup packed dark brown sugar	3/4 cup packed dark brown sugar	1
¾ cup unsweetened pineapple juice	3/4 cup unsweetened pineapple juice	1
2 teaspoons baking powder	2 teaspoons baking powder	1
½ teaspoon vanilla extract	1/2 teaspoon vanilla extract	1
1 fresh pineapple - peeled, cored and cut into rings	1 fresh pineapple - peeled , cored and cut into rings	1
2 skinless, boneless chicken breast halves - cut into chunks	2 skinless , boneless chicken breast halves - cut into chunks	1
3 cloves garlic, minced	3 cloves garlic , minced	2
1 small butternut squash, peeled and chopped	1 small butternut squash , peeled and chopped	1
1 carrot, peeled and chopped	1 carrot , peeled and chopped	1
1 tablespoon sugar	1 tablespoon sugar	1
1 teaspoon ground coriander	1 teaspoon ground coriander	1
1 dash cayenne pepper	1 dash cayenne pepper	1
1 ¾ cups all-purpose flour	1 3/4 cups all-purpose flour	2
4 teaspoons baking powder	4 teaspoons baking powder	1
⅛ teaspoon salt	⅛ teaspoon salt	1
5 tablespoons unsalted butter	5 tablespoons unsalted butter	1
⅓ cup dried currants	1/3 cup dried currants	1
1 egg, lightly beaten	1 egg , lightly beaten	1
1 tablespoon milk	1 tablespoon milk	1
1 ⅓ cups all-purpose flour	1 1/3 cups all-purpose flour	1
3 tablespoons unsweetened cocoa powder	3 tablespoons unsweetened cocoa powder	1
¼ teaspoon baking soda	1/4 teaspoon baking soda	1
¼ cup butter, softened	1/4 cup butter , softened	2
2 large eggs	2 large eggs	1
1 tablespoon red food coloring	1 tablespoon red food coloring	1
¼ cup light olive oil	1/4 cup light olive oil	1
½ teaspoon almond extract	1/2 teaspoon almond extract	1
½ cup dried cranberries	1/2 cup dried cranberries	1
1 ½ cups pistachio nuts	1 1/2 cups pistachio nuts	1
1 cup butter, softened	1 cup butter , softened	2
1 teaspoon grated orange zest	1 teaspoon grated orange zest	1
2 tablespoons orange juice	2 tablespoons orange juice	1
2 ½ cups all-purpose flour	2 1/2 cups all-purpose flour	1
2 cups chopped cranberries	2 cups chopped cranberries	1
½ cup chopped walnuts (optional)	1/2 cup chopped walnuts -lrb- optional -rrb-	1
½ teaspoon grated orange zest	1/2 teaspoon grated orange zest	1
3 tablespoons orange juice	3 tablespoons orange juice	1
1 ½ cups confectioners' sugar	1 1/2 cups confectioners ' sugar	1
2 ⅛ cups white sugar	2 ⅛ cups white sugar	1
1 ½ teaspoons baking soda	1 1/2 teaspoons baking soda	1
1 ½ cups buttermilk	1 1/2 cups buttermilk	1
2 teaspoons lemon juice	2 teaspoons lemon juice	1
1 ½ cups mashed bananas	1 1/2 cups mashed bananas	1
1 (8 ounce) package cream cheese, softened	1 -lrb- 8 ounce -rrb- package cream cheese , softened	1
3 ½ cups confectioners' sugar	3 1/2 cups confectioners ' sugar	1
3 tablespoons cornstarch	3 tablespoons cornstarch	1
½ teaspoon ground cinnamon	1/2 teaspoon ground cinnamon	2
4 cups fresh blueberries	4 cups fresh blueberries	1
2 cups white sugar	2 cups white sugar	1
1 ⅝ cups all-purpose flour	1 ⅝ cups all-purpose flour	1
1 cup fresh or frozen blueberries	1 cup fresh or frozen blueberries	1
1 tablespoon confectioners' sugar for dusting	1 tablespoon confectioners ' sugar for dusting	1
1 ¼ cups white sugar	1 1/4 cups white sugar	1
3 cups diced rhubarb	3 cups diced rhubarb	1
¼ cup all-purpose flour	1/4 cup all-purpose flour	2
ground cinnamon, for dusting	ground cinnamon , for dusting	1
1 cup all-purpose flour	1 cup all-purpose flour	1
3 cups chopped rhubarb	3 cups chopped rhubarb	1
1 tablespoon all-purpose flour	1 tablespoon all-purpose flour	1
2 (8 ounce) packages cream cheese	2 -lrb- 8 ounce -rrb- packages cream cheese	1
3 ½ cups water, divided	3 1/2 cups water , divided	1
1 ½ cups low fat, low sodium chicken broth	1 1/2 cups low fat , low sodium chicken broth	1
1 cup uncooked wild rice	1 cup uncooked wild rice	1
⅓ pound bacon	1/3 pound bacon	1
3 cups diced onions	3 cups diced onions	1
3 cups diced celery	3 cups diced celery	1
1 tablespoon water	1 tablespoon water	1
1 cup uncooked long-grain white rice	1 cup uncooked long-grain white rice	1
1 ¾ cups currants	1 3/4 cups currants	1
¾ cup dried cherries	3/4 cup dried cherries	1
½ ounce dried apricots	1/2 ounce dried apricots	1
1 cup diced, unpeeled apples	1 cup diced , unpeeled apples	1
½ cup chopped Italian flat leaf parsley	1/2 cup chopped italian flat leaf parsley	1
6 tablespoons dried mixed herbs	6 tablespoons dried mixed herbs	1
6 skinless, boneless chicken breast halves	6 skinless , boneless chicken breast halves	2
1 lemon	1 lemon	1
3 cups fresh sliced mushrooms	3 cups fresh sliced mushrooms	1
½ cup chicken broth, or more as needed	1/2 cup chicken broth , or more as needed	1
1 tablespoon chopped fresh parsley	1 tablespoon chopped fresh parsley	1
½ cup finely crushed herb-seasoned stuffing mix	1/2 cup finely crushed herb-seasoned stuffing mix	1
1 tablespoon Italian-style seasoning	1 tablespoon italian-style seasoning	1
½ cup Italian-style salad dressing	1/2 cup italian-style salad dressing	1
1 head iceberg lettuce	1 head iceberg lettuce	1
1 head romaine lettuce, rinsed and dried	1 head romaine lettuce , rinsed and dried	1
2 bunches green onions, chopped	2 bunches green onions , chopped	1
1 large tomato, chopped	1 large tomato , chopped	1
1 ½ cups shredded Cheddar and Monterey cheese blend	1 1/2 cups shredded cheddar and monterey cheese blend	1
5 (6 inch) flour tortillas	5 -lrb- 6 inch -rrb- flour tortillas	1
½ cup ranch-style salad dressing	1/2 cup ranch-style salad dressing	1
1 ½ cups uncooked wild rice	1 1/2 cups uncooked wild rice	1
6 cups water	6 cups water	1
⅓ cup tarragon vinegar	1/3 cup tarragon vinegar	1
1 tablespoon white sugar	1 tablespoon white sugar	1
1 teaspoon dried tarragon, crumbled	1 teaspoon dried tarragon , crumbled	1
½ teaspoon black pepper	1/2 teaspoon black pepper	1
½ teaspoon crushed red pepper flakes	1/2 teaspoon crushed red pepper flakes	1
⅔ cup safflower oil	2/3 cup safflower oil	2
3 cups cubed cooked chicken	3 cups cubed cooked chicken	1
1 cup sliced celery	1 cup sliced celery	1
½ cup chopped fresh parsley	1/2 cup chopped fresh parsley	1
½ cup sliced green onion	1/2 cup sliced green onion	1
½ pound sugar snap peas, strings removed	1/2 pound sugar snap peas , strings removed	1
½ cup toasted slivered almonds	1/2 cup toasted slivered almonds	1
2 tablespoons sesame oil	2 tablespoons sesame oil	1
4 boneless, skinless chicken breasts	4 boneless , skinless chicken breasts	1
5 cups water	5 cups water	1
2 (6 ounce) packages long grain and wild rice mix	2 -lrb- 6 ounce -rrb- packages long grain and wild rice mix	1
1 tablespoon butter (optional)	1 tablespoon butter -lrb- optional -rrb-	1
1 (8 ounce) can sliced water chestnuts, drained	1 -lrb- 8 ounce -rrb- can sliced water chestnuts , drained	1
1 cup chopped green onion	1 cup chopped green onion	1
1 cup chopped almonds	1 cup chopped almonds	1
6 lettuce leaves, or as needed	6 lettuce leaves , or as needed	1
1 (5 ounce) can chow mein noodles	1 -lrb- 5 ounce -rrb- can chow mein noodles	1
1 ⅔ cups uncooked brown rice	1 2/3 cups uncooked brown rice	1
2 ½ cups water	2 1/2 cups water	1
1 cup low fat sour cream	1 cup low fat sour cream	1
1 tablespoon red wine vinegar	1 tablespoon red wine vinegar	1
2 teaspoons honey	2 teaspoons honey	1
¼ teaspoon chili powder	1/4 teaspoon chili powder	1
⅛ teaspoon black pepper	⅛ teaspoon black pepper	2
1 cup diced red bell pepper	1 cup diced red bell pepper	1
1 cup chopped green onions	1 cup chopped green onions	1
½ cup frozen green peas, thawed	1/2 cup frozen green peas , thawed	1
¼ cup toasted almond slices	1/4 cup toasted almond slices	1
2 tablespoons chopped cilantro	2 tablespoons chopped cilantro	1
2 Granny Smith apples, thinly sliced	2 granny smith apples , thinly sliced	1
½ lemon, juiced	1/2 lemon , juiced	2
6 cups thinly sliced kale	6 cups thinly sliced kale	1
4 slices cooked bacon, crumbled	4 slices cooked bacon , crumbled	1
½ avocado, thinly sliced	1/2 avocado , thinly sliced	1
¼ cup chopped almonds	1/4 cup chopped almonds	1
¼ cup apple cider vinegar	1/4 cup apple cider vinegar	2
2 tablespoons maple syrup	2 tablespoons maple syrup	1
2 teaspoons grainy mustard	2 teaspoons grainy mustard	1
2 pounds butternut squash - peeled, seeded, and chopped	2 pounds butternut squash - peeled , seeded , and chopped	1
2 small onions, chopped	2 small onions , chopped	1
2 small carrots, peeled and chopped	2 small carrots , peeled and chopped	1
2 stalks celery, chopped	2 stalks celery , chopped	2
2 ½ teaspoons ground cinnamon, divided	2 1/2 teaspoons ground cinnamon , divided	1
½ teaspoon ground nutmeg	1/2 teaspoon ground nutmeg	2
¼ cup maple syrup	1/4 cup maple syrup	1
1 cup heavy whipping cream	1 cup heavy whipping cream	1
2 cups peeled and diced Granny Smith apples	2 cups peeled and diced granny smith apples	1
3 tablespoons olive oil	3 tablespoons olive oil	1
3 tablespoons curry powder	3 tablespoons curry powder	1
½ teaspoon grated fresh ginger root	1/2 teaspoon grated fresh ginger root	1
½ teaspoon white sugar	1/2 teaspoon white sugar	1
2 skinless, boneless chicken breast halves - cut into bite-size pieces	2 skinless , boneless chicken breast halves - cut into bite-size pieces	1
1 tablespoon tomato paste	1 tablespoon tomato paste	1
1 cup plain yogurt	1 cup plain yogurt	1
¾ cup coconut milk	3/4 cup coconut milk	1
8 ounces farfalle (bow tie) pasta	8 ounces farfalle -lrb- bow tie -rrb- pasta	1
½ teaspoon prepared mustard	1/2 teaspoon prepared mustard	1
2 ½ cups shredded Colby cheese	2 1/2 cups shredded colby cheese	1
4 ounces cooked ham, julienned	4 ounces cooked ham , julienned	1
1 recipe pastry for a 9 inch single crust pie	1 recipe pastry for a 9 inch single crust pie	1
1 egg yolk	1 egg yolk	1
¼ teaspoon ground cloves	1/4 teaspoon ground cloves	1
1 ½ cups milk	1 1/2 cups milk	1
½ cup heavy whipping cream	1/2 cup heavy whipping cream	1
2 cups pumpkin puree	2 cups pumpkin puree	1
1 (9 inch) unbaked pie crust	1 -lrb- 9 inch -rrb- unbaked pie crust	2
1 (10 ounce) package frozen broccoli florets	1 -lrb- 10 ounce -rrb- package frozen broccoli florets	1
1 onion, minced	1 onion , minced	1
1 teaspoon garlic, minced	1 teaspoon garlic , minced	1
1 ½ cups diced cooked ham	1 1/2 cups diced cooked ham	1
1 ½ cups shredded Cheddar cheese	1 1/2 cups shredded cheddar cheese	1
1 cup milk	1 cup milk	1
1 teaspoon smoked paprika	1 teaspoon smoked paprika	1
⅓ cup white sugar	1/3 cup white sugar	1
¼ cup canola oil	1/4 cup canola oil	1
1 ½ tablespoons prepared yellow mustard	1 1/2 tablespoons prepared yellow mustard	1
½ teaspoon celery seed	1/2 teaspoon celery seed	1
1 (9 ounce) bag fresh spinach, chopped	1 -lrb- 9 ounce -rrb- bag fresh spinach , chopped	1
⅔ cup herb-seasoned stuffing mix (such as Pepperidge Farm&reg; Cubed Herb Seasoned Stuffing)	2/3 cup herb-seasoned stuffing mix -lrb- such as pepperidge farm & reg ; cubed herb seasoned stuffing -rrb-	1
⅓ cup crumbled cooked bacon	1/3 cup crumbled cooked bacon	1
2 cups fusilli (spiral) pasta	2 cups fusilli -lrb- spiral -rrb- pasta	1
1 ½ cups cubed cooked chicken	1 1/2 cups cubed cooked chicken	1
6 tablespoons chopped onion	6 tablespoons chopped onion	1
¼ cup dried cranberries	1/4 cup dried cranberries	1
¼ cup chopped celery	1/4 cup chopped celery	1
¼ cup slivered almonds	1/4 cup slivered almonds	1
½ cup poppy seed salad dressing	1/2 cup poppy seed salad dressing	1
1 head romaine lettuce, chopped	1 head romaine lettuce , chopped	1
1 green bell pepper, cut into 1/2-inch dice	1 green bell pepper , cut into 1/2-inch dice	1
½ red onion, cut into 1/4-inch slices	1/2 red onion , cut into 1/4-inch slices	1
1 cucumber, sliced - or amount to taste	1 cucumber , sliced - or amount to taste	1
1 tablespoon poppy seeds	1 tablespoon poppy seeds	1
1 teaspoon dry mustard powder	1 teaspoon dry mustard powder	1
1 (10 ounce) package frozen peas, thawed and drained	1 -lrb- 10 ounce -rrb- package frozen peas , thawed and drained	1
2 cups cubed fully cooked ham	2 cups cubed fully cooked ham	1
¾ cup mayonnaise	3/4 cup mayonnaise	1
2 tablespoons onion, chopped	2 tablespoons onion , chopped	1
1 ½ teaspoons mustard	1 1/2 teaspoons mustard	1
2 tablespoons GOYA&reg; Extra Virgin Olive Oil, divided	2 tablespoons goya & reg ; extra virgin olive oil , divided	1
4 (5 ounce) boneless, skinless chicken breast fillets	4 -lrb- 5 ounce -rrb- boneless , skinless chicken breast fillets	1
GOYA&reg; Adobo All-Purpose Seasoning with Pepper, to taste	goya & reg ; adobo all-purpose seasoning with pepper , to taste	1
½ red onion, finely chopped	1/2 red onion , finely chopped	1
½ red bell pepper, finely chopped	1/2 red bell pepper , finely chopped	1
½ cup fresh corn kernels	1/2 cup fresh corn kernels	1
1 avocado, finely chopped	1 avocado , finely chopped	1
1 tablespoon GOYA&reg; Lemon Juice	1 tablespoon goya & reg ; lemon juice	1
1 tablespoon finely chopped fresh cilantro	1 tablespoon finely chopped fresh cilantro	1
1 (3 1/2) pound chicken, cut into 8 pieces	1 -lrb- 3 1/2 -rrb- pound chicken , cut into 8 pieces	1
Goya Adobo with Pepper, to taste	goya adobo with pepper , to taste	1
3 tablespoons Goya Extra Virgin Olive Oil	3 tablespoons goya extra virgin olive oil	1
1 cup yellow onion, finely chopped	1 cup yellow onion , finely chopped	1
¾ cup green bell pepper, finely chopped	3/4 cup green bell pepper , finely chopped	1
1 ½ teaspoons Goya Minced Garlic	1 1/2 teaspoons goya minced garlic	1
1 ½ cups Canilla Extra Long Grain Rice	1 1/2 cups canilla extra long grain rice	1
1 packet Goya Powdered Chicken Bouillon	1 packet goya powdered chicken bouillon	1
1 packet Sazon Goya with Azafran	1 packet sazon goya with azafran	1
¼ cup Goya Pitted Alcaparrado, sliced	1/4 cup goya pitted alcaparrado , sliced	1
1 (4 ounce) jar Goya Fancy Sliced Pimientos	1 -lrb- 4 ounce -rrb- jar goya fancy sliced pimientos	1
½ cup Goya Frozen Peas, thawed	1/2 cup goya frozen peas , thawed	1
8 ounces bacon, cut into 1 inch pieces	8 ounces bacon , cut into 1 inch pieces	1
¾ cup orange juice	3/4 cup orange juice	1
¼ cup shallots, minced	1/4 cup shallots , minced	1
¼ cup balsamic vinegar	1/4 cup balsamic vinegar	1
4 large oranges, peeled and segmented	4 large oranges , peeled and segmented	1
10 ounces spinach, rinsed and chopped	10 ounces spinach , rinsed and chopped	1
1 medium head radicchio	1 medium head radicchio	1
6 ounces fresh shiitake mushrooms, stemmed and sliced	6 ounces fresh shiitake mushrooms , stemmed and sliced	1
6 ounces fresh oyster mushrooms, stemmed and sliced	6 ounces fresh oyster mushrooms , stemmed and sliced	1
½ cup chopped toasted hazelnuts	1/2 cup chopped toasted hazelnuts	1
1 (3 ounce) package enoki mushrooms	1 -lrb- 3 ounce -rrb- package enoki mushrooms	1
1 pound elbow macaroni	1 pound elbow macaroni	1
½ small red onion, diced very small	1/2 small red onion , diced very small	1
½ small green bell pepper, diced very small	1/2 small green bell pepper , diced very small	1
1 (1 ounce) package ranch salad dressing mix	1 -lrb- 1 ounce -rrb- package ranch salad dressing mix	1
1 (8 ounce) package Cheddar cheese, cut into small cubes	1 -lrb- 8 ounce -rrb- package cheddar cheese , cut into small cubes	1
¾ cup water	3/4 cup water	1
¼ cup uncooked wild rice	1/4 cup uncooked wild rice	1
1 cup cubed cooked ham	1 cup cubed cooked ham	1
⅓ cup finely chopped red bell pepper	1/3 cup finely chopped red bell pepper	1
¼ cup thinly sliced green onion tops	1/4 cup thinly sliced green onion tops	1
1 (4 ounce) can sliced mushrooms, drained	1 -lrb- 4 ounce -rrb- can sliced mushrooms , drained	1
1 tablespoon Dijon mustard	1 tablespoon dijon mustard	1
2 cups shredded Swiss cheese	2 cups shredded swiss cheese	1
1 cup chopped onions	1 cup chopped onions	1
1 ½ pounds ground pork	1 1/2 pounds ground pork	1
1 ½ pounds ground beef	1 1/2 pounds ground beef	1
1 (3 pound) whole cooked chicken, deboned and shredded	1 -lrb- 3 pound -rrb- whole cooked chicken , deboned and shredded	1
1 cup ketchup	1 cup ketchup	1
½ cup hickory flavored barbeque sauce	1/2 cup hickory flavored barbeque sauce	1
hot sauce to taste (optional)	hot sauce to taste -lrb- optional -rrb-	1
1 green bell pepper	1 green bell pepper	1
1 tablespoon dried rosemary	1 tablespoon dried rosemary	1
2 pounds boneless pork loin roast	2 pounds boneless pork loin roast	1
½ cup white wine	1/2 cup white wine	1
½ cup all-purpose flour	1/2 cup all-purpose flour	1
10 chicken wings	10 chicken wings	1
oil for deep frying	oil for deep frying	1
¼ cup hot sauce	1/4 cup hot sauce	1
1 dash ground black pepper	1 dash ground black pepper	1
1 dash garlic powder	1 dash garlic powder	1
10 slices bacon	10 slices bacon	1
1 head fresh broccoli, cut into bite size pieces	1 head fresh broccoli , cut into bite size pieces	1
¼ cup red onion, chopped	1/4 cup red onion , chopped	1
½ cup raisins	1/2 cup raisins	1
3 tablespoons white wine vinegar	3 tablespoons white wine vinegar	2
2 tablespoons white sugar	2 tablespoons white sugar	3
1 cup mayonnaise	1 cup mayonnaise	7
1 cup sunflower seeds	1 cup sunflower seeds	1
2 heads fresh broccoli	2 heads fresh broccoli	1
1 red onion	1 red onion	1
½ pound bacon	1/2 pound bacon	2
¾ cup raisins	3/4 cup raisins	1
¾ cup sliced almonds	3/4 cup sliced almonds	1
½ cup white sugar	1/2 cup white sugar	7
2 tablespoons white wine vinegar	2 tablespoons white wine vinegar	1
4 skinless, boneless chicken breast halves - cooked and diced	4 skinless , boneless chicken breast halves - cooked and diced	1
1 stalk celery, diced	1 stalk celery , diced	1
4 green onions, chopped	4 green onions , chopped	3
1 Golden Delicious apple - peeled, cored and diced	1 golden delicious apple - peeled , cored and diced	1
⅓ cup golden raisins	1/3 cup golden raisins	1
⅓ cup seedless green grapes, halved	1/3 cup seedless green grapes , halved	1
½ cup chopped toasted pecans	1/2 cup chopped toasted pecans	1
⅛ teaspoon ground black pepper	⅛ teaspoon ground black pepper	2
½ teaspoon curry powder	1/2 teaspoon curry powder	1
¾ cup light mayonnaise	3/4 cup light mayonnaise	1
4 cups cubed, cooked chicken meat	4 cups cubed , cooked chicken meat	1
1 teaspoon paprika	1 teaspoon paprika	2
1 ½ cups dried cranberries	1 1/2 cups dried cranberries	1
1 cup chopped celery	1 cup chopped celery	3
2 green onions, chopped	2 green onions , chopped	1
½ cup minced green bell pepper	1/2 cup minced green bell pepper	1
1 cup chopped pecans	1 cup chopped pecans	2
1 teaspoon seasoning salt	1 teaspoon seasoning salt	1
ground black pepper to taste	ground black pepper to taste	2
¾ cup cashew halves	3/4 cup cashew halves	1
4 slices bacon, coarsely chopped	4 slices bacon , coarsely chopped	1
1 tablespoon melted butter	1 tablespoon melted butter	1
1 teaspoon chopped fresh rosemary	1 teaspoon chopped fresh rosemary	1
1 teaspoon curry powder	1 teaspoon curry powder	2
1 tablespoon brown sugar	1 tablespoon brown sugar	3
½ teaspoon kosher salt	1/2 teaspoon kosher salt	2
½ teaspoon cayenne pepper	1/2 teaspoon cayenne pepper	2
3 tablespoons Dijon mustard	3 tablespoons dijon mustard	3
2 tablespoons honey	2 tablespoons honey	1
½ cup olive oil	1/2 cup olive oil	2
salt and black pepper to taste	salt and black pepper to taste	2
1 (10 ounce) package mixed salad greens	1 -lrb- 10 ounce -rrb- package mixed salad greens	2
½ medium Bosc pear, thinly sliced	1/2 medium bosc pear , thinly sliced	1
½ cup halved seedless red grapes	1/2 cup halved seedless red grapes	1
2 pounds maple-flavored bacon	2 pounds maple-flavored bacon	1
1 large head fresh broccoli, chopped	1 large head fresh broccoli , chopped	1
¾ cup chopped celery	3/4 cup chopped celery	1
¼ cup minced green onions	1/4 cup minced green onions	1
¼ cup diced red onion	1/4 cup diced red onion	1
1 ½ cups seedless grapes, halved	1 1/2 cups seedless grapes , halved	1
¾ cup blanched slivered almonds	3/4 cup blanched slivered almonds	1
¼ cup white sugar	1/4 cup white sugar	5
2 tablespoons distilled white vinegar	2 tablespoons distilled white vinegar	1
2 skinless, boneless chicken breast halves	2 skinless , boneless chicken breast halves	2
1 tablespoon vegetable oil	1 tablespoon vegetable oil	1
1 (11 ounce) can Mexican-style corn	1 -lrb- 11 ounce -rrb- can mexican-style corn	1
½ cup salsa	1/2 cup salsa	2
1 onion, chopped	1 onion , chopped	7
1 tomato, cut into wedges	1 tomato , cut into wedges	1
6 eggs	6 eggs	1
2 pounds spinach, rinsed and chopped	2 pounds spinach , rinsed and chopped	1
2 ¾ ounces croutons	2 3/4 ounces croutons	1
¼ cup sliced fresh mushrooms	1/4 cup sliced fresh mushrooms	1
⅔ cup white sugar	2/3 cup white sugar	2
1 teaspoon salt	1 teaspoon salt	10
1 cup vegetable oil	1 cup vegetable oil	2
⅓ cup cider vinegar	1/3 cup cider vinegar	2
½ teaspoon ground black pepper	1/2 teaspoon ground black pepper	5
1 teaspoon celery seed	1 teaspoon celery seed	1
1 tablespoon prepared Dijon-style mustard	1 tablespoon prepared dijon-style mustard	1
½ cup white vinegar	1/2 cup white vinegar	1
2 tablespoons Worcestershire sauce	2 tablespoons worcestershire sauce	1
⅓ cup ketchup	1/3 cup ketchup	1
1 small onion, chopped	1 small onion , chopped	3
5 slices bacon	5 slices bacon	1
3 eggs	3 eggs	5
1 pound fresh spinach - rinsed, dried and torn into bite size pieces	1 pound fresh spinach - rinsed , dried and torn into bite size pieces	1
1 (4 ounce) can sliced water chestnuts, drained	1 -lrb- 4 ounce -rrb- can sliced water chestnuts , drained	1
2 cups water	2 cups water	4
2 cubes chicken bouillon	2 cubes chicken bouillon	1
1 clove garlic, smashed	1 clove garlic , smashed	1
1 cup uncooked quinoa	1 cup uncooked quinoa	1
2 large cooked chicken breasts - cut into bite size pieces	2 large cooked chicken breasts - cut into bite size pieces	1
1 large red onion, diced	1 large red onion , diced	1
1 large green bell pepper, diced	1 large green bell pepper , diced	1
½ cup chopped kalamata olives	1/2 cup chopped kalamata olives	1
½ cup crumbled feta cheese	1/2 cup crumbled feta cheese	3
¼ cup chopped fresh parsley	1/4 cup chopped fresh parsley	1
¼ cup chopped fresh chives	1/4 cup chopped fresh chives	1
½ teaspoon salt	1/2 teaspoon salt	14
⅔ cup fresh lemon juice	2/3 cup fresh lemon juice	1
1 tablespoon balsamic vinegar	1 tablespoon balsamic vinegar	2
¼ cup olive oil	1/4 cup olive oil	5
1 tablespoon olive oil	1 tablespoon olive oil	9
½ pound bacon, cut crosswise into 1-inch pieces	1/2 pound bacon , cut crosswise into 1 inch pieces	1
2 cloves garlic, minced	2 cloves garlic , minced	3
2 teaspoons lemon zest	2 teaspoons lemon zest	1
⅔ cup creme fraiche	2/3 cup creme fraiche	1
2 cups ditalini pasta	2 cups ditalini pasta	1
2 cups halved cherry tomatoes	2 cups halved cherry tomatoes	1
4 cups baby arugula, coarsely chopped	4 cups baby arugula , coarsely chopped	1
salt and ground black pepper to taste	salt and ground black pepper to taste	11
1 pinch cayenne pepper, or to taste	1 pinch cayenne pepper , or to taste	2
1 tablespoon freshly shredded Parmesan cheese, or to taste (optional)	1 tablespoon freshly shredded parmesan cheese , or to taste -lrb- optional -rrb-	1
½ cup light mayonnaise	1/2 cup light mayonnaise	1
½ cup low-fat sour cream	1/2 cup low-fat sour cream	1
¼ teaspoon paprika	1/4 teaspoon paprika	2
2 tablespoons prepared horseradish	2 tablespoons prepared horseradish	2
2 tablespoons chopped red onion	2 tablespoons chopped red onion	1
¼ cup real bacon bits	1/4 cup real bacon bits	1
salt and pepper to taste	salt and pepper to taste	12
½ pound ground pork sausage	1/2 pound ground pork sausage	1
12 eggs, beaten	12 eggs , beaten	1
½ (4 ounce) can chopped green chile peppers, drained	1/2 -lrb- 4 ounce -rrb- can chopped green chile peppers , drained	1
1 teaspoon garlic powder	1 teaspoon garlic powder	2
1 Granny Smith apple, cored and julienned	1 granny smith apple , cored and julienned	1
1 cup balsamic vinaigrette salad dressing	1 cup balsamic vinaigrette salad dressing	1
1 cup crumbled blue cheese	1 cup crumbled blue cheese	1
½ cup chopped pecans	1/2 cup chopped pecans	3
4 slices turkey bacon	4 slices turkey bacon	1
6 cups torn romaine lettuce	6 cups torn romaine lettuce	1
3 tablespoons butter	3 tablespoons butter	5
4 sweet onions, thinly sliced	4 sweet onions , thinly sliced	1
2 firm pears, peeled, quartered, and sliced	2 firm pears , peeled , quartered , and sliced	1
¾ cup crumbled blue cheese	3/4 cup crumbled blue cheese	1
1 pound bulk pork sausage	1 pound bulk pork sausage	1
1 pound ground beef	1 pound ground beef	2
1 large onion, diced	1 large onion , diced	1
4 cups water	4 cups water	1
1 (10 ounce) can diced tomatoes with green chile peppers (such as RO*TEL&reg;), undrained	1 -lrb- 10 ounce -rrb- can diced tomatoes with green chile peppers -lrb- such as ro * tel & reg ;-rrb- , undrained	1
1 teaspoon Worcestershire sauce	1 teaspoon worcestershire sauce	1
¾ teaspoon garlic salt	3/4 teaspoon garlic salt	1
1 (4 ounce) can chopped green chilies	1 -lrb- 4 ounce -rrb- can chopped green chilies	1
4 teaspoons molasses	4 teaspoons molasses	1
4 beef bouillon cubes	4 beef bouillon cubes	1
¼ teaspoon ground black pepper	1/4 teaspoon ground black pepper	6
¼ teaspoon ground cumin	1/4 teaspoon ground cumin	1
4 tablespoons lemon juice	4 tablespoons lemon juice	1
4 tablespoons olive oil	4 tablespoons olive oil	1
2 tablespoons coarse grained prepared mustard	2 tablespoons coarse grained prepared mustard	1
9 baking potatoes	9 baking potatoes	1
⅔ cup butter	2/3 cup butter	1
⅔ cup all-purpose flour	2/3 cup all-purpose flour	2
6 cups whole milk	6 cups whole milk	1
½ tablespoon salt	1/2 tablespoon salt	1
1 teaspoon ground black pepper	1 teaspoon ground black pepper	4
½ cup bacon bits, divided	1/2 cup bacon bits , divided	1
10 ounces shredded Cheddar cheese	10 ounces shredded cheddar cheese	1
1 (8 ounce) container sour cream	1 -lrb- 8 ounce -rrb- container sour cream	1
⅓ cup brown sugar	1/3 cup brown sugar	1
1 teaspoon ground cinnamon	1 teaspoon ground cinnamon	4
½ cup butter, softened	1/2 cup butter , softened	2
2 eggs	2 eggs	6
1 ½ teaspoons vanilla extract	1 1/2 teaspoons vanilla extract	1
1 ½ cups all-purpose flour	1 1/2 cups all-purpose flour	2
1 ¾ teaspoons baking powder	1 3/4 teaspoons baking powder	1
½ cup milk	1/2 cup milk	4
1 apple, peeled and chopped	1 apple , peeled and chopped	1
2 prepared pie crusts	2 prepared pie crusts	1
4 cups peeled and sliced apples	4 cups peeled and sliced apples	1
2 cups cranberries	2 cups cranberries	1
¾ cup white sugar	3/4 cup white sugar	5
1 tablespoon cornstarch	1 tablespoon cornstarch	1
2 tablespoons butter, cut into small pieces	2 tablespoons butter , cut into small pieces	1
1 pound sweet Italian sausage, casings removed	1 pound sweet italian sausage , casings removed	1
¼ cup butter	1/4 cup butter	6
6 cups coarsely chopped leeks	6 cups coarsely chopped leeks	1
3 tart apples - peeled, cored and chopped	3 tart apples - peeled , cored and chopped	1
2 cups chopped celery	2 cups chopped celery	1
4 teaspoons poultry seasoning	4 teaspoons poultry seasoning	1
2 teaspoons dried rosemary, crushed	2 teaspoons dried rosemary , crushed	1
1 cup dried cranberries	1 cup dried cranberries	1
12 cups white bread cubes, baked until slightly dry	12 cups white bread cubes , baked until slightly dry	1
1 ⅓ cups chicken stock	1 1/3 cups chicken stock	1
1 pound bacon, chopped	1 pound bacon , chopped	1
2 medium green bell peppers, chopped	2 medium green bell peppers , chopped	1
¼ teaspoon pepper	1/4 teaspoon pepper	1
2 tablespoons fresh lemon juice	2 tablespoons fresh lemon juice	1
1 ½ pounds small new potatoes, unpeeled	1 1/2 pounds small new potatoes , unpeeled	1
2 teaspoons corn oil	2 teaspoons corn oil	1
1 skinless, boneless chicken breast half - cut into bite-size pieces	1 skinless , boneless chicken breast half - cut into bite-size pieces	1
½ teaspoon garlic powder	1/2 teaspoon garlic powder	2
1 ½ tablespoons mayonnaise	1 1/2 tablespoons mayonnaise	1
½ lime, juiced	1/2 lime , juiced	1
½ teaspoon ground ginger	1/2 teaspoon ground ginger	2
2 teaspoons milk	2 teaspoons milk	1
2 cups fresh spinach, stems removed	2 cups fresh spinach , stems removed	1
4 fresh strawberries, sliced	4 fresh strawberries , sliced	1
1 ½ tablespoons slivered almonds	1 1/2 tablespoons slivered almonds	1
freshly ground black pepper to taste	freshly ground black pepper to taste	3
1 pound ground pork sausage	1 pound ground pork sausage	1
1 teaspoon mustard powder	1 teaspoon mustard powder	1
4 eggs, beaten	4 eggs , beaten	2
2 cups milk	2 cups milk	5
6 slices white bread, toasted and cut into cubes	6 slices white bread , toasted and cut into cubes	1
8 ounces mild Cheddar cheese, shredded	8 ounces mild cheddar cheese , shredded	1
8 ounces bacon	8 ounces bacon	1
8 ounces broccoli, cut into florets	8 ounces broccoli , cut into florets	1
8 slices bread	8 slices bread	1
2 tablespoons butter, softened	2 tablespoons butter , softened	2
¾ cup shredded Cheddar cheese	3/4 cup shredded cheddar cheese	1
12 eggs	12 eggs	1
½ teaspoon dry mustard	1/2 teaspoon dry mustard	1
8 medium red potatoes	8 medium red potatoes	1
4 eggs	4 eggs	2
8 slices bacon	8 slices bacon	1
3 green onions, diced	3 green onions , diced	1
3 fresh jalapeno peppers, diced	3 fresh jalapeno peppers , diced	1
½ green bell pepper, diced	1/2 green bell pepper , diced	1
2 ½ cups mayonnaise	2 1/2 cups mayonnaise	1
2 tablespoons brown mustard	2 tablespoons brown mustard	1
1 teaspoon Cajun seasoning	1 teaspoon cajun seasoning	1
1 (8 ounce) package PHILADELPHIA Cream Cheese, softened	1 -lrb- 8 ounce -rrb- package philadelphia cream cheese , softened	1
1 (6 ounce) package OSCAR MAYER Deli Fresh Oven Roasted Chicken Breast Cuts	1 -lrb- 6 ounce -rrb- package oscar mayer deli fresh oven roasted chicken breast cuts	1
½ cup hot pepper sauce for Buffalo wings	1/2 cup hot pepper sauce for buffalo wings	1
¼ cup KRAFT Natural Blue Cheese Crumbles	1/4 cup kraft natural blue cheese crumbles	1
2 green onions, sliced	2 green onions , sliced	1
1 large onion, chopped	1 large onion , chopped	2
3 cloves garlic, peeled and chopped	3 cloves garlic , peeled and chopped	1
2 (10 ounce) packages chopped frozen broccoli, thawed	2 -lrb- 10 ounce -rrb- packages chopped frozen broccoli , thawed	2
1 potato, peeled and chopped	1 potato , peeled and chopped	1
4 cups chicken broth	4 cups chicken broth	1
¼ teaspoon ground nutmeg	1/4 teaspoon ground nutmeg	3
1 cup uncooked long grain white rice	1 cup uncooked long grain white rice	1
1 onion, diced	1 onion , diced	3
2 cups marinara sauce	2 cups marinara sauce	1
1 cup beef broth	1 cup beef broth	1
¼ teaspoon crushed red pepper flakes	1/4 teaspoon crushed red pepper flakes	1
1 pound lean ground beef	1 pound lean ground beef	1
¼ pound hot Italian pork sausage, casing removed	1/4 pound hot italian pork sausage , casing removed	1
1 (10 ounce) can diced tomatoes	1 -lrb- 10 ounce -rrb- can diced tomatoes	1
¼ cup chopped fresh Italian parsley	1/4 cup chopped fresh italian parsley	1
4 cloves garlic, minced	4 cloves garlic , minced	1
2 teaspoons salt	2 teaspoons salt	2
1 teaspoon freshly ground black pepper	1 teaspoon freshly ground black pepper	1
1 pinch ground cayenne pepper	1 pinch ground cayenne pepper	1
4 large green bell peppers, halved lengthwise and seeded	4 large green bell peppers , halved lengthwise and seeded	1
1 cup finely grated Parmigiano-Reggiano cheese, plus more for topping	1 cup finely grated parmigiano-reggiano cheese , plus more for topping	1
1 ¼ cups all-purpose flour	1 1/4 cups all-purpose flour	1
½ cup butter, cut into chunks	1/2 cup butter , cut into chunks	1
2 tablespoons sour cream	2 tablespoons sour cream	1
4 fresh peaches - peeled, pitted, and sliced	4 fresh peaches - peeled , pitted , and sliced	1
3 egg yolks	3 egg yolks	1
2 tablespoons all-purpose flour	2 tablespoons all-purpose flour	4
⅓ cup sour cream	1/3 cup sour cream	1
1 cup white sugar	1 cup white sugar	5
¾ cup buttermilk	3/4 cup buttermilk	2
¾ cup vegetable oil	3/4 cup vegetable oil	1
1 ½ cups white sugar	1 1/2 cups white sugar	1
2 teaspoons vanilla extract	2 teaspoons vanilla extract	3
2 teaspoons ground cinnamon	2 teaspoons ground cinnamon	1
¼ teaspoon salt	1/4 teaspoon salt	10
2 cups all-purpose flour	2 cups all-purpose flour	2
2 teaspoons baking soda	2 teaspoons baking soda	1
2 cups shredded carrots	2 cups shredded carrots	1
1 cup flaked coconut	1 cup flaked coconut	1
1 cup chopped walnuts	1 cup chopped walnuts	1
1 (8 ounce) can crushed pineapple with juice	1 -lrb- 8 ounce -rrb- can crushed pineapple with juice	1
1 cup raisins	1 cup raisins	1
1 cup whole wheat flour	1 cup whole wheat flour	1
⅓ cup wheat germ	1/3 cup wheat germ	1
1 ½ teaspoons baking powder	1 1/2 teaspoons baking powder	1
½ teaspoon baking soda	1/2 teaspoon baking soda	2
2 tablespoons brown sugar	2 tablespoons brown sugar	1
5 ⅓ tablespoons unsalted butter	5 1/3 tablespoons unsalted butter	1
2 ½ cups buttermilk	2 1/2 cups buttermilk	1
2 eggs, beaten	2 eggs , beaten	3
3 tablespoons unsalted butter	3 tablespoons unsalted butter	1
1 teaspoon extra-virgin olive oil, or to taste	1 teaspoon extra-virgin olive oil , or to taste	1
1 cup quinoa, rinsed	1 cup quinoa , rinsed	1
2 cups chicken broth	2 cups chicken broth	1
2 cups chopped cooked chicken	2 cups chopped cooked chicken	1
12 grape tomatoes, quartered	12 grape tomatoes , quartered	1
¼ cup finely chopped fresh basil	1/4 cup finely chopped fresh basil	1
¼ cup grated Parmesan cheese	1/4 cup grated parmesan cheese	2
1 clove garlic, minced	1 clove garlic , minced	4
¼ cup extra-virgin olive oil	1/4 cup extra-virgin olive oil	1
¼ teaspoon red pepper flakes	1/4 teaspoon red pepper flakes	1
1 ¾ cups water	1 3/4 cups water	1
1 cup quinoa	1 cup quinoa	1
¾ cup dried cranberries	3/4 cup dried cranberries	2
1 cup bite-size broccoli pieces	1 cup bite-size broccoli pieces	1
2 tablespoons olive oil	2 tablespoons olive oil	4
1 tablespoon orange juice	1 tablespoon orange juice	1
1 tablespoon lime juice	1 tablespoon lime juice	1
½ cup chopped walnuts	1/2 cup chopped walnuts	1
1 head fresh broccoli, chopped	1 head fresh broccoli , chopped	1
1 cup shredded Cheddar cheese	1 cup shredded cheddar cheese	2
¾ cup all-purpose flour	3/4 cup all-purpose flour	1
¼ teaspoon dry mustard	1/4 teaspoon dry mustard	1
¼ cup butter, melted	1/4 cup butter , melted	1
1 tablespoon butter	1 tablespoon butter	7
¼ pound fresh mushrooms, sliced	1/4 pound fresh mushrooms , sliced	1
1 cup half-and-half cream	1 cup half-and-half cream	1
3 eggs, beaten	3 eggs , beaten	2
1 whole roasting chicken, cut in quarters	1 whole roasting chicken , cut in quarters	1
1 large onion, sliced	1 large onion , sliced	1
8 ounces fresh mushrooms, quartered	8 ounces fresh mushrooms , quartered	1
1 pinch salt	1 pinch salt	3
1 pinch ground black pepper	1 pinch ground black pepper	2
4 cloves garlic, sliced	4 cloves garlic , sliced	1
3 sprigs rosemary	3 sprigs rosemary	1
1 teaspoon dried oregano	1 teaspoon dried oregano	3
½ teaspoon red pepper flakes, or to taste	1/2 teaspoon red pepper flakes , or to taste	1
1 cup tomato sauce	1 cup tomato sauce	1
½ cup water	1/2 cup water	3
2 red bell peppers, sliced	2 red bell peppers , sliced	1
2 green bell peppers, sliced	2 green bell peppers , sliced	1
1 cup uncooked elbow macaroni	1 cup uncooked elbow macaroni	1
1 stalk celery, chopped	1 stalk celery , chopped	3
¼ cup mayonnaise	1/4 cup mayonnaise	1
¼ cup sour cream	1/4 cup sour cream	2
2 tablespoons milk	2 tablespoons milk	1
1 (10 ounce) can chicken chunks, drained	1 -lrb- 10 ounce -rrb- can chicken chunks , drained	1
1 (1 ounce) package dry Ranch-style dressing mix	1 -lrb- 1 ounce -rrb- package dry ranch-style dressing mix	1
2 teaspoons paprika	2 teaspoons paprika	1
1 tablespoon olive oil, or as needed	1 tablespoon olive oil , or as needed	1
1 skinless, boneless chicken breast half, cut into cubes	1 skinless , boneless chicken breast half , cut into cubes	1
1 large sweet potato, peeled and cut into 1/2-inch pieces	1 large sweet potato , peeled and cut into 1/2-inch pieces	1
1 tablespoon Irish whiskey	1 tablespoon irish whiskey	1
1 tablespoon minced fresh sage	1 tablespoon minced fresh sage	1
1 pear - peeled, cored, and cut into 1/2-inch pieces	1 pear - peeled , cored , and cut into 1/2-inch pieces	1
2 cups baby spinach	2 cups baby spinach	1
¼ cup chopped toasted hazelnuts	1/4 cup chopped toasted hazelnuts	1
2 (1 1/2 pound) pork tenderloin, trimmed of silver skin	2 -lrb- 1 1/2 pound -rrb- pork tenderloin , trimmed of silver skin	1
½ onion, chopped	1/2 onion , chopped	4
⅓ cup fresh thyme leaves	1/3 cup fresh thyme leaves	1
¼ cup white vinegar	1/4 cup white vinegar	1
4 cloves garlic	4 cloves garlic	1
2 habanero peppers, seeded, or more to taste	2 habanero peppers , seeded , or more to taste	1
2 tablespoons minced fresh ginger	2 tablespoons minced fresh ginger	1
2 tablespoons soy sauce	2 tablespoons soy sauce	2
2 tablespoons vegetable oil	2 tablespoons vegetable oil	1
2 teaspoons ground allspice	2 teaspoons ground allspice	1
¼ teaspoon cayenne pepper	1/4 teaspoon cayenne pepper	3
¼ teaspoon ground cinnamon	1/4 teaspoon ground cinnamon	1
1 bunch asparagus, trimmed and cut into 1/2-inch pieces	1 bunch asparagus , trimmed and cut into 1/2-inch pieces	1
2 tablespoons unsalted butter	2 tablespoons unsalted butter	1
1 cup cold milk	1 cup cold milk	1
1 teaspoon kosher salt	1 teaspoon kosher salt	1
½ clove garlic, minced	1/2 clove garlic , minced	1
4 eggs, separated	4 eggs , separated	1
½ cup grated sharp white Cheddar cheese	1/2 cup grated sharp white cheddar cheese	1
½ pound uncooked orzo pasta	1/2 pound uncooked orzo pasta	1
⅓ cup red wine vinegar	1/3 cup red wine vinegar	1
1 teaspoon Dijon mustard	1 teaspoon dijon mustard	1
¾ teaspoon garlic powder	3/4 teaspoon garlic powder	1
¾ teaspoon dried oregano	3/4 teaspoon dried oregano	1
¾ teaspoon dried basil	3/4 teaspoon dried basil	1
¾ teaspoon onion powder	3/4 teaspoon onion powder	1
½ cup grape tomatoes, cut in half	1/2 cup grape tomatoes , cut in half	1
¼ cup black olives, cut in half lengthwise	1/4 cup black olives , cut in half lengthwise	1
2 ounces crumbled feta cheese	2 ounces crumbled feta cheese	1
1 grilled chicken breast half, diced	1 grilled chicken breast half , diced	1
2 red bell peppers, cut in half lengthwise and seeded	2 red bell peppers , cut in half lengthwise and seeded	1
4 sprigs fresh oregano	4 sprigs fresh oregano	1
2 cups orzo pasta	2 cups orzo pasta	1
2 (10 ounce) packages baby spinach	2 -lrb- 10 ounce -rrb- packages baby spinach	1
3 cups chopped grilled chicken	3 cups chopped grilled chicken	1
2 roma tomatoes, diced	2 roma tomatoes , diced	1
½ cup pine nuts	1/2 cup pine nuts	1
¼ cup chopped sun-dried tomatoes	1/4 cup chopped sun-dried tomatoes	1
2 tablespoons capers, or to taste (optional)	2 tablespoons capers , or to taste -lrb- optional -rrb-	1
1 cup balsamic vinegar	1 cup balsamic vinegar	1
⅓ cup olive oil	1/3 cup olive oil	1
2 tablespoons dried parsley	2 tablespoons dried parsley	1
2 teaspoons dried basil	2 teaspoons dried basil	1
2 cloves garlic, pressed	2 cloves garlic , pressed	1
¼ cup freshly grated Parmesan cheese, or to taste	1/4 cup freshly grated parmesan cheese , or to taste	1
2 chicken breast halves, boneless, skin-on	2 chicken breast halves , boneless , skin-on	1
8 ounces fresh mushrooms, sliced 1/4 inch thick	8 ounces fresh mushrooms , sliced 1/4 inch thick	1
2 tablespoons butter	2 tablespoons butter	7
2 onions, chopped	2 onions , chopped	1
5 cups chicken broth	5 cups chicken broth	2
2 potatoes, peeled and chopped	2 potatoes , peeled and chopped	1
2 carrots, peeled and thinly sliced	2 carrots , peeled and thinly sliced	1
8 cups chopped zucchini	8 cups chopped zucchini	1
2 tablespoons chopped fresh basil	2 tablespoons chopped fresh basil	1
1 pound baby carrots	1 pound baby carrots	1
water to cover	water to cover	2
2 ½ tablespoons honey	2 1/2 tablespoons honey	1
1 tablespoon lemon juice	1 tablespoon lemon juice	3
⅛ teaspoon ground ginger	⅛ teaspoon ground ginger	1
1 ½ pounds carrots, peeled and diagonally cut into 1/2-inch-wide pieces	1 1/2 pounds carrots , peeled and diagonally cut into 1/2-inch-wide pieces	1
1 tablespoon unsalted butter	1 tablespoon unsalted butter	1
1 tablespoon apple cider vinegar	1 tablespoon apple cider vinegar	1
2 tablespoons chopped fresh dill	2 tablespoons chopped fresh dill	1
½ teaspoon honey	1/2 teaspoon honey	1
½ cup butter	1/2 cup butter	2
1 egg	1 egg	3
1 cup sour cream	1 cup sour cream	5
1 teaspoon vanilla extract	1 teaspoon vanilla extract	5
3 cups all-purpose flour	3 cups all-purpose flour	2
1 teaspoon baking soda	1 teaspoon baking soda	2
1 teaspoon baking powder	1 teaspoon baking powder	4
2 (8 ounce) packages cream cheese, softened	2 -lrb- 8 ounce -rrb- packages cream cheese , softened	1
½ cup brown sugar	1/2 cup brown sugar	2
⅓ cup all-purpose flour	1/3 cup all-purpose flour	1
⅓ cup butter	1/3 cup butter	2
1 ¼ cups warm water (110 degrees F/45 degrees C)	1 1/4 cups warm water -lrb- 110 degrees f/45 degrees c -rrb-	1
3 cups bread flour	3 cups bread flour	1
2 tablespoons dry milk powder	2 tablespoons dry milk powder	1
1 ½ teaspoons salt	1 1/2 teaspoons salt	1
3 tablespoons grated Parmesan cheese	3 tablespoons grated parmesan cheese	2
1 ½ teaspoons dried marjoram	1 1/2 teaspoons dried marjoram	1
1 ½ teaspoons dried thyme	1 1/2 teaspoons dried thyme	1
1 teaspoon dried basil	1 teaspoon dried basil	1
1 tablespoon active dry yeast	1 tablespoon active dry yeast	1
1 cup water	1 cup water	1
½ cup red quinoa	1/2 cup red quinoa	1
2 avocados, peeled and mashed	2 avocados , peeled and mashed	1
2 tablespoons chopped fresh cilantro	2 tablespoons chopped fresh cilantro	1
1 tablespoon fresh lime juice	1 tablespoon fresh lime juice	2
1 pound cubed cooked chicken, chilled	1 pound cubed cooked chicken , chilled	1
2 tomatoes, seeded and chopped	2 tomatoes , seeded and chopped	1
2 tablespoons chopped scallions	2 tablespoons chopped scallions	1
8 ounces whole wheat penne pasta	8 ounces whole wheat penne pasta	1
2 tablespoons extra virgin olive oil	2 tablespoons extra virgin olive oil	1
1 (1 pound) beef rib eye steak	1 -lrb- 1 pound -rrb- beef rib eye steak	1
1 teaspoon minced garlic	1 teaspoon minced garlic	1
¼ cup chopped shallots	1/4 cup chopped shallots	1
1 tablespoon soy sauce	1 tablespoon soy sauce	1
½ cup sun-dried tomato pesto	1/2 cup sun-dried tomato pesto	1
½ cup sliced black olives	1/2 cup sliced black olives	1
1 cup chopped fresh spinach	1 cup chopped fresh spinach	1
1 teaspoon basil	1 teaspoon basil	1
1 tablespoon chopped parsley	1 tablespoon chopped parsley	1
3 tablespoons sunflower kernels	3 tablespoons sunflower kernels	1
2 large boneless, skinless chicken breasts	2 large boneless , skinless chicken breasts	1
1 ½ cups quinoa	1 1/2 cups quinoa	1
1 tablespoon chicken bouillon granules	1 tablespoon chicken bouillon granules	1
1 small butternut squash, peeled and cut into 1/2-inch dice	1 small butternut squash , peeled and cut into 1/2-inch dice	1
1 cup sweetened dried cranberries (such as Craisins&reg;)	1 cup sweetened dried cranberries -lrb- such as craisins & reg ;-rrb-	1
2 tablespoons fresh parsley, or more to taste	2 tablespoons fresh parsley , or more to taste	1
1 cup seashell pasta	1 cup seashell pasta	1
1 cup chopped, cooked chicken meat	1 cup chopped , cooked chicken meat	1
3 green onions, chopped into 1 inch pieces	3 green onions , chopped into 1 inch pieces	1
1 red bell pepper, chopped	1 red bell pepper , chopped	1
1 cup sliced black olives	1 cup sliced black olives	1
1 cucumber, peeled and chopped	1 cucumber , peeled and chopped	1
⅔ cup Italian-style salad dressing	2/3 cup italian-style salad dressing	1
¼ cup sunflower seeds (optional)	1/4 cup sunflower seeds -lrb- optional -rrb-	1
½ cup mayonnaise	1/2 cup mayonnaise	2
1 (10 ounce) package frozen chopped spinach, thawed and drained	1 -lrb- 10 ounce -rrb- package frozen chopped spinach , thawed and drained	1
2 cloves garlic, chopped	2 cloves garlic , chopped	1
4 skinless, boneless chicken breasts	4 skinless , boneless chicken breasts	2
4 slices bacon	4 slices bacon	1
6 slices bacon	6 slices bacon	3
⅓ cup apple cider vinegar	1/3 cup apple cider vinegar	1
½ red onion, coarsely chopped	1/2 red onion , coarsely chopped	1
½ teaspoon dry mustard powder	1/2 teaspoon dry mustard powder	1
½ cup vegetable oil	1/2 cup vegetable oil	1
1 teaspoon poppy seeds	1 teaspoon poppy seeds	1
10 cups torn romaine lettuce leaves	10 cups torn romaine lettuce leaves	1
1 (10 ounce) can mandarin orange segments, drained	1 -lrb- 10 ounce -rrb- can mandarin orange segments , drained	1
¼ cup toasted slivered almonds	1/4 cup toasted slivered almonds	1
2 cooked chicken breast halves, diced	2 cooked chicken breast halves , diced	1
1 ripe avocado, sliced	1 ripe avocado , sliced	1
½ cup sour cream	1/2 cup sour cream	2
1 ½ teaspoons ground black pepper	1 1/2 teaspoons ground black pepper	1
1 teaspoon lime juice	1 teaspoon lime juice	1
½ teaspoon onion powder	1/2 teaspoon onion powder	1
¼ cup pineapple juice	1/4 cup pineapple juice	1
3 tablespoons red wine vinegar	3 tablespoons red wine vinegar	1
salt to taste	salt to taste	3
1 (10 ounce) package chopped romaine lettuce	1 -lrb- 10 ounce -rrb- package chopped romaine lettuce	1
1 cup diced fresh pineapple	1 cup diced fresh pineapple	1
½ cup chopped and toasted macadamia nuts	1/2 cup chopped and toasted macadamia nuts	1
3 green onions, chopped	3 green onions , chopped	1
¼ cup flaked coconut, toasted	1/4 cup flaked coconut , toasted	1
4 slices bacon, chopped	4 slices bacon , chopped	1
2 avocados - peeled, pitted, and cubed	2 avocados - peeled , pitted , and cubed	1
3 green onions, finely chopped	3 green onions , finely chopped	1
red leaf lettuce	red leaf lettuce	1
1 cup shredded sharp Cheddar cheese	1 cup shredded sharp cheddar cheese	1
½ teaspoon garlic salt	1/2 teaspoon garlic salt	1
½ teaspoon seasoned salt	1/2 teaspoon seasoned salt	1
1 ½ teaspoons lemon juice	1 1/2 teaspoons lemon juice	1
12 buttery round crackers, crushed fine	12 buttery round crackers , crushed fine	1
2 slices bacon	2 slices bacon	2
1 tablespoon bacon drippings	1 tablespoon bacon drippings	1
1 cup chopped onion	1 cup chopped onion	1
½ cup diced celery	1/2 cup diced celery	1
½ cup diced green bell pepper	1/2 cup diced green bell pepper	1
½ cup diced red bell pepper	1/2 cup diced red bell pepper	1
1 tablespoon minced fresh thyme	1 tablespoon minced fresh thyme	1
¼ cup minced fresh parsley	1/4 cup minced fresh parsley	1
1 pinch Creole seasoning, or to taste	1 pinch creole seasoning , or to taste	1
5 cloves garlic, minced	5 cloves garlic , minced	1
½ cup beef broth	1/2 cup beef broth	1
2 (6 ounce) packages frozen peas, thawed	2 -lrb- 6 ounce -rrb- packages frozen peas , thawed	1
1 pound cooked bacon, chopped	1 pound cooked bacon , chopped	1
1 cup golden raisins	1 cup golden raisins	1
1 (8 ounce) package shredded Cheddar cheese	1 -lrb- 8 ounce -rrb- package shredded cheddar cheese	1
1 sweet onion, chopped	1 sweet onion , chopped	1
½ cup sunflower seeds	1/2 cup sunflower seeds	1
2 tablespoons wine vinegar	2 tablespoons wine vinegar	1
¼ teaspoon white sugar, or to taste	1/4 teaspoon white sugar , or to taste	1
1 pound skinless, boneless chicken breast halves - cut into 1 inch cubes	1 pound skinless , boneless chicken breast halves - cut into 1 inch cubes	1
1 pound andouille sausage, sliced	1 pound andouille sausage , sliced	1
1 large green bell pepper, chopped	1 large green bell pepper , chopped	1
1 cup chicken broth	1 cup chicken broth	1
2 teaspoons dried oregano	2 teaspoons dried oregano	2
2 teaspoons dried parsley	2 teaspoons dried parsley	1
2 teaspoons Cajun seasoning	2 teaspoons cajun seasoning	1
1 teaspoon cayenne pepper	1 teaspoon cayenne pepper	1
½ teaspoon dried thyme	1/2 teaspoon dried thyme	1
1 pound frozen cooked shrimp without tails	1 pound frozen cooked shrimp without tails	1
1 ¾ pounds diced chicken breast meat	1 3/4 pounds diced chicken breast meat	1
2 green bell peppers, diced	2 green bell peppers , diced	1
2 red bell peppers, diced	2 red bell peppers , diced	1
½ cup frozen corn kernels	1/2 cup frozen corn kernels	1
2 teaspoons chili powder	2 teaspoons chili powder	1
1 tablespoon dried parsley	1 tablespoon dried parsley	2
½ teaspoon ground cayenne pepper	1/2 teaspoon ground cayenne pepper	1
½ teaspoon ground cumin	1/2 teaspoon ground cumin	2
4 pounds pork baby back ribs	4 pounds pork baby back ribs	1
2 cups ketchup	2 cups ketchup	1
1 cup chili sauce	1 cup chili sauce	1
½ cup packed brown sugar	1/2 cup packed brown sugar	3
4 tablespoons vinegar	4 tablespoons vinegar	1
2 teaspoons Worcestershire sauce	2 teaspoons worcestershire sauce	1
1 dash hot sauce	1 dash hot sauce	1
1 bunch fresh asparagus, trimmed	1 bunch fresh asparagus , trimmed	1
1 tablespoon extra-virgin olive oil	1 tablespoon extra-virgin olive oil	1
2 ounces minced prosciutto	2 ounces minced prosciutto	1
ground black pepper	ground black pepper	1
1 teaspoon distilled white vinegar	1 teaspoon distilled white vinegar	1
½ lemon, zested and juiced	1/2 lemon , zested and juiced	1
¾ teaspoon salt	3/4 teaspoon salt	1
¼ teaspoon black pepper	1/4 teaspoon black pepper	1
⅛ teaspoon paprika	⅛ teaspoon paprika	1
¼ teaspoon garlic powder	1/4 teaspoon garlic powder	1
⅛ teaspoon onion powder	⅛ teaspoon onion powder	1
¼ teaspoon dried thyme	1/4 teaspoon dried thyme	1
¼ teaspoon dried parsley	1/4 teaspoon dried parsley	1
4 boneless, skinless chicken breast halves	4 boneless , skinless chicken breast halves	1
2 teaspoons garlic powder	2 teaspoons garlic powder	1
3 tablespoons lime juice	3 tablespoons lime juice	1
1 ½ pounds fresh broccoli, cut into bite size pieces	1 1/2 pounds fresh broccoli , cut into bite size pieces	1
3 tablespoons soy sauce	3 tablespoons soy sauce	1
2 teaspoons white vinegar	2 teaspoons white vinegar	2
⅓ cup chopped salted cashews	1/3 cup chopped salted cashews	1
4 slices thick-cut bacon, sliced into 1/4-inch strips, or more to taste	4 slices thick-cut bacon , sliced into 1/4-inch strips , or more to taste	1
1 pound Brussels sprouts, trimmed and halved, or more to taste	1 pound brussels sprouts , trimmed and halved , or more to taste	1
1 clove garlic, thinly sliced, or more to taste	1 clove garlic , thinly sliced , or more to taste	1
½ cup chicken stock, or more as needed	1/2 cup chicken stock , or more as needed	1
1 tablespoon butter, or to taste	1 tablespoon butter , or to taste	1
1 tablespoon balsamic vinegar, or more to taste	1 tablespoon balsamic vinegar , or more to taste	1
4 pounds Brussels sprouts, trimmed and thinly sliced	4 pounds brussels sprouts , trimmed and thinly sliced	1
6 slices bacon, chopped	6 slices bacon , chopped	1
⅓ cup sliced almonds	1/3 cup sliced almonds	1
2 tablespoons minced garlic	2 tablespoons minced garlic	1
2 tablespoons red wine vinegar	2 tablespoons red wine vinegar	1
⅓ cup plain bread crumbs	1/3 cup plain bread crumbs	1
1 pound ground pork	1 pound ground pork	1
¼ bunch fresh parsley, chopped	1/4 bunch fresh parsley , chopped	1
3 cloves garlic, crushed	3 cloves garlic , crushed	1
½ teaspoon red pepper flakes	1/2 teaspoon red pepper flakes	1
1 teaspoon dried Italian herb seasoning	1 teaspoon dried italian herb seasoning	1
2 tablespoons grated Parmesan cheese	2 tablespoons grated parmesan cheese	1
1 (3 to 3 1/2 pound) whole chicken	1 -lrb- 3 to 3 1/2 pound -rrb- whole chicken	1
2 ½ quarts cold water	2 1/2 quarts cold water	1
1 large carrot, cubed	1 large carrot , cubed	1
3 sprigs fresh thyme	3 sprigs fresh thyme	1
1 bay leaf	1 bay leaf	2
2 tablespoons all-purpose flour, or as needed	2 tablespoons all-purpose flour , or as needed	1
salt and freshly ground black pepper to taste	salt and freshly ground black pepper to taste	1
½ teaspoon cayenne pepper, or more to taste	1/2 teaspoon cayenne pepper , or more to taste	1
½ cup creme fraiche	1/2 cup creme fraiche	1
2 teaspoons chopped fresh thyme leaves	2 teaspoons chopped fresh thyme leaves	1
2 cups self-rising flour	2 cups self-rising flour	1
4 sprigs thyme, for garnish	4 sprigs thyme , for garnish	1
3 cups chicken broth	3 cups chicken broth	1
8 cups broccoli florets	8 cups broccoli florets	1
3 tablespoons all-purpose flour	3 tablespoons all-purpose flour	1
¼ cup melted butter	1/4 cup melted butter	1
¼ cup flour	1/4 cup flour	1
2 cups chicken stock	2 cups chicken stock	1
1 ½ cups coarsely chopped broccoli florets	1 1/2 cups coarsely chopped broccoli florets	1
1 cup matchstick-cut carrots	1 cup matchstick-cut carrots	1
1 stalk celery, thinly sliced	1 stalk celery , thinly sliced	1
2 ½ cups shredded sharp Cheddar cheese	2 1/2 cups shredded sharp cheddar cheese	1
4 cups chopped rhubarb	4 cups chopped rhubarb	1
1 ⅓ cups white sugar	1 1/3 cups white sugar	1
6 tablespoons all-purpose flour	6 tablespoons all-purpose flour	1
1 recipe pastry for a 9 inch double crust pie	1 recipe pastry for a 9 inch double crust pie	2
¾ cup butter	3/4 cup butter	2
¾ cup packed dark brown sugar	3/4 cup packed dark brown sugar	1
¾ cup unsweetened pineapple juice	3/4 cup unsweetened pineapple juice	1
2 teaspoons baking powder	2 teaspoons baking powder	1
½ teaspoon vanilla extract	1/2 teaspoon vanilla extract	1
1 fresh pineapple - peeled, cored and cut into rings	1 fresh pineapple - peeled , cored and cut into rings	1
2 skinless, boneless chicken breast halves - cut into chunks	2 skinless , boneless chicken breast halves - cut into chunks	1
3 cloves garlic, minced	3 cloves garlic , minced	2
1 small butternut squash, peeled and chopped	1 small butternut squash , peeled and chopped	1
1 carrot, peeled and chopped	1 carrot , peeled and chopped	1
1 tablespoon sugar	1 tablespoon sugar	1
1 teaspoon ground coriander	1 teaspoon ground coriander	1
1 dash cayenne pepper	1 dash cayenne pepper	1
1 ¾ cups all-purpose flour	1 3/4 cups all-purpose flour	2
4 teaspoons baking powder	4 teaspoons baking powder	1
⅛ teaspoon salt	⅛ teaspoon salt	1
5 tablespoons unsalted butter	5 tablespoons unsalted butter	1
⅓ cup dried currants	1/3 cup dried currants	1
1 egg, lightly beaten	1 egg , lightly beaten	1
1 tablespoon milk	1 tablespoon milk	1
1 ⅓ cups all-purpose flour	1 1/3 cups all-purpose flour	1
3 tablespoons unsweetened cocoa powder	3 tablespoons unsweetened cocoa powder	1
¼ teaspoon baking soda	1/4 teaspoon baking soda	1
¼ cup butter, softened	1/4 cup butter , softened	2
2 large eggs	2 large eggs	1
1 tablespoon red food coloring	1 tablespoon red food coloring	1
¼ cup light olive oil	1/4 cup light olive oil	1
½ teaspoon almond extract	1/2 teaspoon almond extract	1
½ cup dried cranberries	1/2 cup dried cranberries	1
1 ½ cups pistachio nuts	1 1/2 cups pistachio nuts	1
1 cup butter, softened	1 cup butter , softened	2
1 teaspoon grated orange zest	1 teaspoon grated orange zest	1
2 tablespoons orange juice	2 tablespoons orange juice	1
2 ½ cups all-purpose flour	2 1/2 cups all-purpose flour	1
2 cups chopped cranberries	2 cups chopped cranberries	1
½ cup chopped walnuts (optional)	1/2 cup chopped walnuts -lrb- optional -rrb-	1
½ teaspoon grated orange zest	1/2 teaspoon grated orange zest	1
3 tablespoons orange juice	3 tablespoons orange juice	1
1 ½ cups confectioners' sugar	1 1/2 cups confectioners ' sugar	1
2 ⅛ cups white sugar	2 ⅛ cups white sugar	1
1 ½ teaspoons baking soda	1 1/2 teaspoons baking soda	1
1 ½ cups buttermilk	1 1/2 cups buttermilk	1
2 teaspoons lemon juice	2 teaspoons lemon juice	1
1 ½ cups mashed bananas	1 1/2 cups mashed bananas	1
1 (8 ounce) package cream cheese, softened	1 -lrb- 8 ounce -rrb- package cream cheese , softened	1
3 ½ cups confectioners' sugar	3 1/2 cups confectioners ' sugar	1
3 tablespoons cornstarch	3 tablespoons cornstarch	1
½ teaspoon ground cinnamon	1/2 teaspoon ground cinnamon	2
4 cups fresh blueberries	4 cups fresh blueberries	1
2 cups white sugar	2 cups white sugar	1
1 ⅝ cups all-purpose flour	1 ⅝ cups all-purpose flour	1
1 cup fresh or frozen blueberries	1 cup fresh or frozen blueberries	1
1 tablespoon confectioners' sugar for dusting	1 tablespoon confectioners ' sugar for dusting	1
1 ¼ cups white sugar	1 1/4 cups white sugar	1
3 cups diced rhubarb	3 cups diced rhubarb	1
¼ cup all-purpose flour	1/4 cup all-purpose flour	2
ground cinnamon, for dusting	ground cinnamon , for dusting	1
1 cup all-purpose flour	1 cup all-purpose flour	1
3 cups chopped rhubarb	3 cups chopped rhubarb	1
1 tablespoon all-purpose flour	1 tablespoon all-purpose flour	1
2 (8 ounce) packages cream cheese	2 -lrb- 8 ounce -rrb- packages cream cheese	1
3 ½ cups water, divided	3 1/2 cups water , divided	1
1 ½ cups low fat, low sodium chicken broth	1 1/2 cups low fat , low sodium chicken broth	1
1 cup uncooked wild rice	1 cup uncooked wild rice	1
⅓ pound bacon	1/3 pound bacon	1
3 cups diced onions	3 cups diced onions	1
3 cups diced celery	3 cups diced celery	1
1 tablespoon water	1 tablespoon water	1
1 cup uncooked long-grain white rice	1 cup uncooked long-grain white rice	1
1 ¾ cups currants	1 3/4 cups currants	1
¾ cup dried cherries	3/4 cup dried cherries	1
½ ounce dried apricots	1/2 ounce dried apricots	1
1 cup diced, unpeeled apples	1 cup diced , unpeeled apples	1
½ cup chopped Italian flat leaf parsley	1/2 cup chopped italian flat leaf parsley	1
6 tablespoons dried mixed herbs	6 tablespoons dried mixed herbs	1
6 skinless, boneless chicken breast halves	6 skinless , boneless chicken breast halves	2
1 lemon	1 lemon	1
3 cups fresh sliced mushrooms	3 cups fresh sliced mushrooms	1
½ cup chicken broth, or more as needed	1/2 cup chicken broth , or more as needed	1
1 tablespoon chopped fresh parsley	1 tablespoon chopped fresh parsley	1
½ cup finely crushed herb-seasoned stuffing mix	1/2 cup finely crushed herb-seasoned stuffing mix	1
1 tablespoon Italian-style seasoning	1 tablespoon italian-style seasoning	1
½ cup Italian-style salad dressing	1/2 cup italian-style salad dressing	1
1 head iceberg lettuce	1 head iceberg lettuce	1
1 head romaine lettuce, rinsed and dried	1 head romaine lettuce , rinsed and dried	1
2 bunches green onions, chopped	2 bunches green onions , chopped	1
1 large tomato, chopped	1 large tomato , chopped	1
1 ½ cups shredded Cheddar and Monterey cheese blend	1 1/2 cups shredded cheddar and monterey cheese blend	1
5 (6 inch) flour tortillas	5 -lrb- 6 inch -rrb- flour tortillas	1
½ cup ranch-style salad dressing	1/2 cup ranch-style salad dressing	1
1 ½ cups uncooked wild rice	1 1/2 cups uncooked wild rice	1
6 cups water	6 cups water	1
⅓ cup tarragon vinegar	1/3 cup tarragon vinegar	1
1 tablespoon white sugar	1 tablespoon white sugar	1
1 teaspoon dried tarragon, crumbled	1 teaspoon dried tarragon , crumbled	1
½ teaspoon black pepper	1/2 teaspoon black pepper	1
½ teaspoon crushed red pepper flakes	1/2 teaspoon crushed red pepper flakes	1
⅔ cup safflower oil	2/3 cup safflower oil	2
3 cups cubed cooked chicken	3 cups cubed cooked chicken	1
1 cup sliced celery	1 cup sliced celery	1
½ cup chopped fresh parsley	1/2 cup chopped fresh parsley	1
½ cup sliced green onion	1/2 cup sliced green onion	1
½ pound sugar snap peas, strings removed	1/2 pound sugar snap peas , strings removed	1
½ cup toasted slivered almonds	1/2 cup toasted slivered almonds	1
2 tablespoons sesame oil	2 tablespoons sesame oil	1
4 boneless, skinless chicken breasts	4 boneless , skinless chicken breasts	1
5 cups water	5 cups water	1
2 (6 ounce) packages long grain and wild rice mix	2 -lrb- 6 ounce -rrb- packages long grain and wild rice mix	1
1 tablespoon butter (optional)	1 tablespoon butter -lrb- optional -rrb-	1
1 (8 ounce) can sliced water chestnuts, drained	1 -lrb- 8 ounce -rrb- can sliced water chestnuts , drained	1
1 cup chopped green onion	1 cup chopped green onion	1
1 cup chopped almonds	1 cup chopped almonds	1
6 lettuce leaves, or as needed	6 lettuce leaves , or as needed	1
1 (5 ounce) can chow mein noodles	1 -lrb- 5 ounce -rrb- can chow mein noodles	1
1 ⅔ cups uncooked brown rice	1 2/3 cups uncooked brown rice	1
2 ½ cups water	2 1/2 cups water	1
1 cup low fat sour cream	1 cup low fat sour cream	1
1 tablespoon red wine vinegar	1 tablespoon red wine vinegar	1
2 teaspoons honey	2 teaspoons honey	1
¼ teaspoon chili powder	1/4 teaspoon chili powder	1
⅛ teaspoon black pepper	⅛ teaspoon black pepper	2
1 cup diced red bell pepper	1 cup diced red bell pepper	1
1 cup chopped green onions	1 cup chopped green onions	1
½ cup frozen green peas, thawed	1/2 cup frozen green peas , thawed	1
¼ cup toasted almond slices	1/4 cup toasted almond slices	1
2 tablespoons chopped cilantro	2 tablespoons chopped cilantro	1
2 Granny Smith apples, thinly sliced	2 granny smith apples , thinly sliced	1
½ lemon, juiced	1/2 lemon , juiced	2
6 cups thinly sliced kale	6 cups thinly sliced kale	1
4 slices cooked bacon, crumbled	4 slices cooked bacon , crumbled	1
½ avocado, thinly sliced	1/2 avocado , thinly sliced	1
¼ cup chopped almonds	1/4 cup chopped almonds	1
¼ cup apple cider vinegar	1/4 cup apple cider vinegar	2
2 tablespoons maple syrup	2 tablespoons maple syrup	1
2 teaspoons grainy mustard	2 teaspoons grainy mustard	1
2 pounds butternut squash - peeled, seeded, and chopped	2 pounds butternut squash - peeled , seeded , and chopped	1
2 small onions, chopped	2 small onions , chopped	1
2 small carrots, peeled and chopped	2 small carrots , peeled and chopped	1
2 stalks celery, chopped	2 stalks celery , chopped	2
2 ½ teaspoons ground cinnamon, divided	2 1/2 teaspoons ground cinnamon , divided	1
½ teaspoon ground nutmeg	1/2 teaspoon ground nutmeg	2
¼ cup maple syrup	1/4 cup maple syrup	1
1 cup heavy whipping cream	1 cup heavy whipping cream	1
2 cups peeled and diced Granny Smith apples	2 cups peeled and diced granny smith apples	1
3 tablespoons olive oil	3 tablespoons olive oil	1
3 tablespoons curry powder	3 tablespoons curry powder	1
½ teaspoon grated fresh ginger root	1/2 teaspoon grated fresh ginger root	1
½ teaspoon white sugar	1/2 teaspoon white sugar	1
2 skinless, boneless chicken breast halves - cut into bite-size pieces	2 skinless , boneless chicken breast halves - cut into bite-size pieces	1
1 tablespoon tomato paste	1 tablespoon tomato paste	1
1 cup plain yogurt	1 cup plain yogurt	1
¾ cup coconut milk	3/4 cup coconut milk	1
8 ounces farfalle (bow tie) pasta	8 ounces farfalle -lrb- bow tie -rrb- pasta	1
½ teaspoon prepared mustard	1/2 teaspoon prepared mustard	1
2 ½ cups shredded Colby cheese	2 1/2 cups shredded colby cheese	1
4 ounces cooked ham, julienned	4 ounces cooked ham , julienned	1
1 recipe pastry for a 9 inch single crust pie	1 recipe pastry for a 9 inch single crust pie	1
1 egg yolk	1 egg yolk	1
¼ teaspoon ground cloves	1/4 teaspoon ground cloves	1
1 ½ cups milk	1 1/2 cups milk	1
½ cup heavy whipping cream	1/2 cup heavy whipping cream	1
2 cups pumpkin puree	2 cups pumpkin puree	1
1 (9 inch) unbaked pie crust	1 -lrb- 9 inch -rrb- unbaked pie crust	2
1 (10 ounce) package frozen broccoli florets	1 -lrb- 10 ounce -rrb- package frozen broccoli florets	1
1 onion, minced	1 onion , minced	1
1 teaspoon garlic, minced	1 teaspoon garlic , minced	1
1 ½ cups diced cooked ham	1 1/2 cups diced cooked ham	1
1 ½ cups shredded Cheddar cheese	1 1/2 cups shredded cheddar cheese	1
1 cup milk	1 cup milk	1
1 teaspoon smoked paprika	1 teaspoon smoked paprika	1
⅓ cup white sugar	1/3 cup white sugar	1
¼ cup canola oil	1/4 cup canola oil	1
1 ½ tablespoons prepared yellow mustard	1 1/2 tablespoons prepared yellow mustard	1
½ teaspoon celery seed	1/2 teaspoon celery seed	1
1 (9 ounce) bag fresh spinach, chopped	1 -lrb- 9 ounce -rrb- bag fresh spinach , chopped	1
⅔ cup herb-seasoned stuffing mix (such as Pepperidge Farm&reg; Cubed Herb Seasoned Stuffing)	2/3 cup herb-seasoned stuffing mix -lrb- such as pepperidge farm & reg ; cubed herb seasoned stuffing -rrb-	1
⅓ cup crumbled cooked bacon	1/3 cup crumbled cooked bacon	1
2 cups fusilli (spiral) pasta	2 cups fusilli -lrb- spiral -rrb- pasta	1
1 ½ cups cubed cooked chicken	1 1/2 cups cubed cooked chicken	1
6 tablespoons chopped onion	6 tablespoons chopped onion	1
¼ cup dried cranberries	1/4 cup dried cranberries	1
¼ cup chopped celery	1/4 cup chopped celery	1
¼ cup slivered almonds	1/4 cup slivered almonds	1
½ cup poppy seed salad dressing	1/2 cup poppy seed salad dressing	1
1 head romaine lettuce, chopped	1 head romaine lettuce , chopped	1
1 green bell pepper, cut into 1/2-inch dice	1 green bell pepper , cut into 1/2-inch dice	1
½ red onion, cut into 1/4-inch slices	1/2 red onion , cut into 1/4-inch slices	1
1 cucumber, sliced - or amount to taste	1 cucumber , sliced - or amount to taste	1
1 tablespoon poppy seeds	1 tablespoon poppy seeds	1
1 teaspoon dry mustard powder	1 teaspoon dry mustard powder	1
1 (10 ounce) package frozen peas, thawed and drained	1 -lrb- 10 ounce -rrb- package frozen peas , thawed and drained	1
2 cups cubed fully cooked ham	2 cups cubed fully cooked ham	1
¾ cup mayonnaise	3/4 cup mayonnaise	1
2 tablespoons onion, chopped	2 tablespoons onion , chopped	1
1 ½ teaspoons mustard	1 1/2 teaspoons mustard	1
2 tablespoons GOYA&reg; Extra Virgin Olive Oil, divided	2 tablespoons goya & reg ; extra virgin olive oil , divided	1
4 (5 ounce) boneless, skinless chicken breast fillets	4 -lrb- 5 ounce -rrb- boneless , skinless chicken breast fillets	1
GOYA&reg; Adobo All-Purpose Seasoning with Pepper, to taste	goya & reg ; adobo all-purpose seasoning with pepper , to taste	1
½ red onion, finely chopped	1/2 red onion , finely chopped	1
½ red bell pepper, finely chopped	1/2 red bell pepper , finely chopped	1
½ cup fresh corn kernels	1/2 cup fresh corn kernels	1
1 avocado, finely chopped	1 avocado , finely chopped	1
1 tablespoon GOYA&reg; Lemon Juice	1 tablespoon goya & reg ; lemon juice	1
1 tablespoon finely chopped fresh cilantro	1 tablespoon finely chopped fresh cilantro	1
1 (3 1/2) pound chicken, cut into 8 pieces	1 -lrb- 3 1/2 -rrb- pound chicken , cut into 8 pieces	1
Goya Adobo with Pepper, to taste	goya adobo with pepper , to taste	1
3 tablespoons Goya Extra Virgin Olive Oil	3 tablespoons goya extra virgin olive oil	1
1 cup yellow onion, finely chopped	1 cup yellow onion , finely chopped	1
¾ cup green bell pepper, finely chopped	3/4 cup green bell pepper , finely chopped	1
1 ½ teaspoons Goya Minced Garlic	1 1/2 teaspoons goya minced garlic	1
1 ½ cups Canilla Extra Long Grain Rice	1 1/2 cups canilla extra long grain rice	1
1 packet Goya Powdered Chicken Bouillon	1 packet goya powdered chicken bouillon	1
1 packet Sazon Goya with Azafran	1 packet sazon goya with azafran	1
¼ cup Goya Pitted Alcaparrado, sliced	1/4 cup goya pitted alcaparrado , sliced	1
1 (4 ounce) jar Goya Fancy Sliced Pimientos	1 -lrb- 4 ounce -rrb- jar goya fancy sliced pimientos	1
½ cup Goya Frozen Peas, thawed	1/2 cup goya frozen peas , thawed	1
8 ounces bacon, cut into 1 inch pieces	8 ounces bacon , cut into 1 inch pieces	1
¾ cup orange juice	3/4 cup orange juice	1
¼ cup shallots, minced	1/4 cup shallots , minced	1
¼ cup balsamic vinegar	1/4 cup balsamic vinegar	1
4 large oranges, peeled and segmented	4 large oranges , peeled and segmented	1
10 ounces spinach, rinsed and chopped	10 ounces spinach , rinsed and chopped	1
1 medium head radicchio	1 medium head radicchio	1
6 ounces fresh shiitake mushrooms, stemmed and sliced	6 ounces fresh shiitake mushrooms , stemmed and sliced	1
6 ounces fresh oyster mushrooms, stemmed and sliced	6 ounces fresh oyster mushrooms , stemmed and sliced	1
½ cup chopped toasted hazelnuts	1/2 cup chopped toasted hazelnuts	1
1 (3 ounce) package enoki mushrooms	1 -lrb- 3 ounce -rrb- package enoki mushrooms	1
1 pound elbow macaroni	1 pound elbow macaroni	1
½ small red onion, diced very small	1/2 small red onion , diced very small	1
½ small green bell pepper, diced very small	1/2 small green bell pepper , diced very small	1
1 (1 ounce) package ranch salad dressing mix	1 -lrb- 1 ounce -rrb- package ranch salad dressing mix	1
1 (8 ounce) package Cheddar cheese, cut into small cubes	1 -lrb- 8 ounce -rrb- package cheddar cheese , cut into small cubes	1
¾ cup water	3/4 cup water	1
¼ cup uncooked wild rice	1/4 cup uncooked wild rice	1
1 cup cubed cooked ham	1 cup cubed cooked ham	1
⅓ cup finely chopped red bell pepper	1/3 cup finely chopped red bell pepper	1
¼ cup thinly sliced green onion tops	1/4 cup thinly sliced green onion tops	1
1 (4 ounce) can sliced mushrooms, drained	1 -lrb- 4 ounce -rrb- can sliced mushrooms , drained	1
1 tablespoon Dijon mustard	1 tablespoon dijon mustard	1
2 cups shredded Swiss cheese	2 cups shredded swiss cheese	1
1 cup chopped onions	1 cup chopped onions	1
1 ½ pounds ground pork	1 1/2 pounds ground pork	1
1 ½ pounds ground beef	1 1/2 pounds ground beef	1
1 (3 pound) whole cooked chicken, deboned and shredded	1 -lrb- 3 pound -rrb- whole cooked chicken , deboned and shredded	1
1 cup ketchup	1 cup ketchup	1
½ cup hickory flavored barbeque sauce	1/2 cup hickory flavored barbeque sauce	1
hot sauce to taste (optional)	hot sauce to taste -lrb- optional -rrb-	1
1 green bell pepper	1 green bell pepper	1
1 tablespoon dried rosemary	1 tablespoon dried rosemary	1
2 pounds boneless pork loin roast	2 pounds boneless pork loin roast	1
½ cup white wine	1/2 cup white wine	1
½ cup all-purpose flour	1/2 cup all-purpose flour	1
10 chicken wings	10 chicken wings	1
oil for deep frying	oil for deep frying	1
¼ cup hot sauce	1/4 cup hot sauce	1
1 dash ground black pepper	1 dash ground black pepper	1
1 dash garlic powder	1 dash garlic powder	1
