abode	abode	1
adguard	adguard	1
ads	ads	1
alarmdecoder	alarmdecoder	1
amcrest	amcrest	1
ampio	ampio	1
android	android	1
apcupsd	apcupsd	1
aqualogic	aqualogic	1
arduino	arduino	1
arest	arest	1
arlo	arlo	1
arwn	arwn	1
asuswrt	asuswrt	1
atome	atome	1
aurora	aurora	1
bbox	bbox	1
beewi	beewi	1
bizkaibus	bizkaibus	1
blink	blink	1
bloomsky	bloomsky	1
bmw	bmw	1
bom	bom	1
broadlink	broadlink	1
canary	canary	1
coinbase	coinbase	1
daikin	daikin	1
danfoss	danfoss	1
de lijn	de lijn	1
deconz	deconz	1
deluge	deluge	1
dovado	dovado	1
dweet	dweet	1
dyson	dyson	1
ebusd	ebusd	1
ecobee	ecobee	1
elk-m1	elk-m1	1
emoncms	emoncms	1
enocean	enocean	1
envisalink	envisalink	1
epson	epson	1
essent	essent	1
ezcontrol	ezcontrol	1
fast	fast	1
fibaro	fibaro	1
freebox	freebox	1
fritzbox	fritzbox	1
fronius	fronius	1
gearbest	gearbest	1
geizhals	geizhals	1
genius hub	genius hub	1
georss	georss	1
github	github	1
gitlab-ci	gitlab-ci	1
gitter	gitter	1
greeneye monitor	greeneye monitor	1
growatt	growatt	1
habitica	habitica	1
haveibeenpwned	haveibeenpwned	1
here	here	1
hive	hive	1
homekit	homekit	1
homematic	homematic	1
homematicip	homematicip	1
huawei	huawei	1
hunter	hunter	1
ihc	ihc	1
ikea	ikea	1
influxdb	influxdb	1
insteon	insteon	1
intergas	intergas	1
iota	iota	1
iperf3	iperf3	1
islamic	islamic	1
isy994	isy994	1
jandy	jandy	1
juicenet	juicenet	1
keba	keba	1
kira	kira	1
knx	knx	1
konnected	konnected	1
kwb	kwb	1
lcn	lcn	1
linky	linky	1
logi	logi	1
luftdaten	luftdaten	1
magicseaweed	magicseaweed	1
melnor	melnor	1
mfi	mfi	1
minut	minut	1
modbus	modbus	1
mopar	mopar	1
mqtt	mqtt	1
mysensors	mysensors	1
n26	n26	1
neato	neato	1
nest	nest	1
netatmo	netatmo	1
netgear	netgear	1
notion	notion	1
oasa	oasa	1
obihai	obihai	1
octoprint	octoprint	1
ombi	ombi	1
opentherm	opentherm	1
openuv	openuv	1
openweathermap	openweathermap	1
orange	orange	1
owlet	owlet	1
pilight	pilight	1
plaato	plaato	1
plex	plex	1
public	public	1
pushbullet	pushbullet	1
qwikswitch	qwikswitch	1
rain	rain	1
rainforest	rainforest	1
rainmachine	rainmachine	1
recollect waste	recollect waste	1
reddit	reddit	1
repetier-server	repetier-server	1
restful	restful	1
rflink	rflink	1
rfxtrx	rfxtrx	1
ring	ring	1
rova	rova	1
sabnzbd	sabnzbd	1
salda	salda	1
scrape	scrape	1
sense	sense	1
shodan	shodan	1
sigfox	sigfox	1
skybell	skybell	1
sleepiq	sleepiq	1
smappee	smappee	1
smartthings	smartthings	1
snmp	snmp	1
solar-log	solar-log	1
solaredge	solaredge	1
solax	solax	1
speedtest	speedtest	1
streamlabs	streamlabs	1
suez	suez	1
tado	tado	1
tahoma	tahoma	1
tautulli	tautulli	1
tcp	tcp	1
telldus	telldus	1
tellstick	tellstick	1
template	template	1
tesla	tesla	1
thermoworks	thermoworks	1
thinking cleaner	thinking cleaner	1
tibber	tibber	1
toon	toon	1
trafikverket	trafikverket	1
transmission	transmission	1
travis-ci	travis-ci	1
twente milieu	twente milieu	1
upnp	upnp	1
uscis	uscis	1
utility	utility	1
vallox	vallox	1
velbus	velbus	1
vera	vera	1
verisure	verisure	1
vultr	vultr	1
waterfurnace	waterfurnace	1
wink	wink	1
wirelesstag	wirelesstag	1
withings	withings	1
xiaomi	xiaomi	1
yahoo	yahoo	1
yandex	yandex	1
z-wave	z-wave	1
zabbix	zabbix	1
zamg	zamg	1
zehnder	zehnder	1
zestimate	zestimate	1
zigbee	zigbee	1
zoneminder	zoneminder	1
kitchen	kitchen	1
bedroom	bedroom	1
ceiling	ceiling	1
wall	wall	1
bathroom	bathroom	1
lobby	lobby	1
living room	living room	1
livingroom	livingroom	1
restroom	restroom	1
toilet	toilet	1
dining room	dining room	1
diningroom	diningroom	1
study room	study room	1
garage	garage	1
apartment	apartment	1
porch	porch	1
loft	loft	1
stair	stair	1
staircase	staircase	1
stir well	stir well	1
entrance	entrance	1
sitting room	sitting room	1
meeting room	meeting room	1
office	office	1
master bedroom	master bedroom	1
quest bedroom	quest bedroom	1
children bedroom	children bedroom	1
dressing room	dressing room	1
storeroom	storeroom	1
store room	store room	1
basement	basement	1
undercroft	undercroft	1
master bathroom	master bathroom	1
wash room	wash room	1
aisle	aisle	1
lounge	lounge	1
bar	bar	1
balcony	balcony	1
gallery	gallery	1
veranda	veranda	1
terrace	terrace	1
