abode home security	abode home security	1
abode	abode	1
ads	ads	1
avi-on	avi-on	1
avi on	avi on	1
belkin wemo	belkin wemo	1
deconz	deconz	1
elgato avea	elgato avea	1
elk-m1 controller	elk-m1 controller	1
elk-m1	elk-m1	1
elk m1	elk m1	1
enocean	enocean	1
eufy	eufy	1
everlights	everlights	1
fibaro	fibaro	1
flux led	flux led	1
magiclight	magiclight	1
greenwave reality	greenwave reality	1
greenwave	greenwave	1
hive	hive	1
homekit controller	homekit controller	1
homekit	homekit	1
homematic	homematic	1
homematicip cloud	homematicip cloud	1
homematicip	homematicip	1
homeworks hub	homeworks hub	1
homeworks	homeworks	1
hyperion	hyperion	1
iglo	iglo	1
ihc	ihc	1
ikea tradfri	ikea tradfri	1
ikea	ikea	1
insteon	insteon	1
isy994 controller	isy994 controller	1
isy994	isy994	1
jandy iaqualink	jandy iaqualink	1
jandy	jandy	1
knx	knx	1
lagute lw-12	lagute lw-12	1
lagute	lagute	1
lcn	lcn	1
leviton decora	leviton decora	1
decora	decora	1
leviton	leviton	1
leviton decora wifi	leviton decora wifi	1
lifx	lifx	1
lightwave	lightwave	1
limitlessled	limitlessled	1
limiteliss led	limiteliss led	1
litejet	litejet	1
lutron	lutron	1
lutron caseta	lutron caseta	1
mochad	mochad	1
mqtt	mqtt	1
mysensors	mysensors	1
mystrom wifi bulb	mystrom wifi bulb	1
mystrom	mystrom	1
nanoleaf	nanoleaf	1
niko	niko	1
niko home control	niko home control	1
opple	opple	1
osram lightify	osram lightify	1
p5 futurenow	p5 futurenow	1
p5	p5	1
philips hue	philips hue	1
hue	hue	1
qwikswitch qsusb	qwikswitch qsusb	1
qwikswitch	qwikswitch	1
rflink	rflink	1
rfxtrx	rfxtrx	1
ring	ring	1
scsgate	scsgate	1
sense hat	sense hat	1
sisyphus	sisyphus	1
skybell	skybell	1
smarthab	smarthab	1
smartthings	smartthings	1
telldus live	telldus live	1
telldus	telldus	1
tellstick	tellstick	1
tikteck	tikteck	1
tp-link smart home	tp-link smart home	1
tp link smart home	tp link smart home	1
tp link	tp link	1
tuya	tuya	1
vera	vera	1
wink	wink	1
x10	x10	1
xiaomi	xiaomi	1
xiaomi philips	xiaomi philips	1
philips	philips	1
yeelight sunflower	yeelight sunflower	1
yeelight	yeelight	1
yeelight wifi	yeelight wifi	1
z-wave	z-wave	1
z wave	z wave	1
zengge	zengge	1
zigbee	zigbee	1
zigbee home	zigbee home	1
kitchen	kitchen	1
bedroom	bedroom	1
ceiling	ceiling	1
wall	wall	1
bathroom	bathroom	1
lobby	lobby	1
living room	living room	1
livingroom	livingroom	1
restroom	restroom	1
toilet	toilet	1
dining room	dining room	1
diningroom	diningroom	1
corridor	corridor	1
drawing room	drawing room	1
garden	garden	1
yard	yard	1
study room	study room	1
garage	garage	1
apartment	apartment	1
porch	porch	1
loft	loft	1
stair	stair	1
staircase	staircase	1
stir well	stir well	1
entrance	entrance	1
sitting room	sitting room	1
meeting room	meeting room	1
office	office	1
master bedroom	master bedroom	1
quest bedroom	quest bedroom	1
children bedroom	children bedroom	1
dressing room	dressing room	1
storeroom	storeroom	1
store room	store room	1
basement	basement	1
undercroft	undercroft	1
master bathroom	master bathroom	1
wash room	wash room	1
aisle	aisle	1
gazebo	gazebo	1
playground	playground	1
lawn	lawn	1
lounge	lounge	1
bar	bar	1
street	street	1
basketball court	basketball court	1
balcony	balcony	1
gallery	gallery	1
veranda	veranda	1
terrace	terrace	1
