abode home	abode home	1
abode	abode	1
amcrest ip	amcrest ip	1
amcrest	amcrest	1
android ip webcam	android ip webcam	1
webcam	webcam	1
arlo	arlo	1
august	august	1
axis	axis	1
blink	blink	1
bloomsky	bloomsky	1
bom australia	bom australia	1
bom	bom	1
buienradar	buienradar	1
canary	canary	1
doorbird	doorbird	1
environment canada	environment canada	1
family hub	family hub	1
ffmpeg	ffmpeg	1
foscam ip camera	foscam ip camera	1
foscam	foscam	1
generic ip	generic ip	1
generic mjpeg	generic mjpeg	1
logi circle	logi circle	1
logi	logi	1
mqtt	mqtt	1
neato robotics	neato robotics	1
neato	neato	1
nest	nest	1
netatmo	netatmo	1
onvif	onvif	1
ring	ring	1
push	push	1
skybell	skybell	1
synology	synology	1
unifi video	unifi video	1
unifi	unifi	1
verisure	verisure	1
vivotek	vivotek	1
xeoma	xeoma	1
xiaomi	xiaomi	1
yi home	yi home	1
zoneminder	zoneminder	1
google	google	1
simplisafe	simplisafe	1
arlo ultra	arlo ultra	1
arlo pro2	arlo pro2	1
blink xt2	blink xt2	1
ring spotlight	ring spotlight	1
ring wifi	ring wifi	1
ring chime	ring chime	1
indoor	indoor	1
outdoor	outdoor	1
netgear	netgear	1
lorex	lorex	1
tp-link	tp-link	1
tp link	tp link	1
eufy	eufy	1
alc	alc	1
angee	angee	1
honeywell	honeywell	1
maximus	maximus	1
night owl	night owl	1
uniden	uniden	1
tend	tend	1
toucan	toucan	1
amazon	amazon	1
samsung	samsung	1
clearview	clearview	1
d link	d link	1
wasserstein	wasserstein	1
insignia	insignia	1
skybell	skybell	1
swann	swann	1
switchmate	switchmate	1
kitchen	kitchen	1
bedroom	bedroom	1
ceiling	ceiling	1
wall	wall	1
bathroom	bathroom	1
lobby	lobby	1
living room	living room	1
livingroom	livingroom	1
restroom	restroom	1
toilet	toilet	1
dining room	dining room	1
diningroom	diningroom	1
corridor	corridor	1
drawing room	drawing room	1
garden	garden	1
yard	yard	1
study room	study room	1
garage	garage	1
apartment	apartment	1
porch	porch	1
loft	loft	1
stair	stair	1
staircase	staircase	1
stir well	stir well	1
entrance	entrance	1
sitting room	sitting room	1
meeting room	meeting room	1
office	office	1
master bedroom	master bedroom	1
quest bedroom	quest bedroom	1
children bedroom	children bedroom	1
dressing room	dressing room	1
storeroom	storeroom	1
store room	store room	1
basement	basement	1
undercroft	undercroft	1
master bathroom	master bathroom	1
wash room	wash room	1
aisle	aisle	1
gazebo	gazebo	1
playground	playground	1
lawn	lawn	1
lounge	lounge	1
bar	bar	1
street	street	1
basketball court	basketball court	1
balcony	balcony	1
gallery	gallery	1
veranda	veranda	1
terrace	terrace	1
