ambiclimate a/c controller	ambiclimate a/c controller	1
ambiclimate	ambiclimate	1
coolmasternet climate	coolmasternet climate	1
coolmasternet	coolmasternet	1
daikin ac	daikin ac	1
daikin	daikin	1
danfoss air	danfoss air	1
danfoss	danfoss	1
dyson	dyson	1
ecobee	ecobee	1
elk-m1 controller	elk-m1 controller	1
elk m1	elk m1	1
eph controls ember	eph controls ember	1
ember	ember	1
eq-3 max! cube	eq-3 max ! cube	1
max!	max !	1
eq3 bluetooth	eq3 bluetooth	1
eq3	eq3	1
ezcontrol xs1	ezcontrol xs1	1
ezcontrol	ezcontrol	1
fibaro	fibaro	1
flexit a/c	flexit a/c	1
flexit	flexit	1
fritzbox	fritzbox	1
genius hub	genius hub	1
genius	genius	1
heatmiser	heatmiser	1
hive	hive	1
homekit controller	homekit controller	1
homekit	homekit	1
homematic	homematic	1
homematicip cloud	homematicip cloud	1
honeywell evohome	honeywell evohome	1
honeywell	honeywell	1
intergas incomfort	intergas incomfort	1
intergas	intergas	1
izone climate	izone climate	1
izone	izone	1
jandy iaqualink	jandy iaqualink	1
iaqualink	iaqualink	1
knx climate	knx climate	1
knx	knx	1
lcn	lcn	1
melissa	melissa	1
mill heater	mill heater	1
mill	mill	1
modbus climate	modbus climate	1
modbus	modbus	1
mqtt hvac	mqtt hvac	1
mqtt	mqtt	1
mysensors hvac	mysensors hvac	1
mysensors	mysensors	1
nest	nest	1
netatmo	netatmo	1
nuheat	nuheat	1
oem	oem	1
openenergymonitor	openenergymonitor	1
opentherm gateway	opentherm gateway	1
opentherm	opentherm	1
plugwise	plugwise	1
proliphix	proliphix	1
radio	radio	1
roth touchline	roth touchline	1
roth	roth	1
sensibo	sensibo	1
smartthings	smartthings	1
spider	spider	1
stiebel eltron	stiebel eltron	1
stiebel	stiebel	1
tado	tado	1
tesla	tesla	1
tfiac	tfiac	1
toon	toon	1
tuya	tuya	1
velbus	velbus	1
venstar	venstar	1
vera	vera	1
viessmann climate	viessmann climate	1
viessmann	viessmann	1
wink	wink	1
z-wave	z-wave	1
z wave	z wave	1
zhonghong	zhonghong	1
bond	bond	1
bunn	bunn	1
cambridge	cambridge	1
dhefman	dhefman	1
better chef	better chef	1
chefman	chefman	1
classicflame	classicflame	1
comfort glow	comfort glow	1
commercial cool	commercial cool	1
danby	danby	1
delonghi	delonghi	1
elite	elite	1
elite cuisine	elite cuisine	1
elite platinum	elite platinum	1
excalibur	excalibur	1
fire sense	fire sense	1
flamelux	flamelux	1
galanz	galanz	1
geek squad	geek squad	1
google	google	1
gourmia	gourmia	1
hamilton beach	hamilton beach	1
hanover	hanover	1
honeywell home	honeywell home	1
impress	impress	1
insignia	insignia	1
jennair	jennair	1
jensen	jensen	1
johnson controls	johnson controls	1
keystone	keystone	1
kitchenaid	kitchenaid	1
l'equip	l'equip	1
l equip	l equip	1
lasko	lasko	1
lg	lg	1
nesco	nesco	1
newair	newair	1
northwest	northwest	1
optimus	optimus	1
oster	oster	1
real flame	real flame	1
sensi	sensi	1
spt	spt	1
t-fal	t-fal	1
t fal	t fal	1
thermador	thermador	1
vornado	vornado	1
warm house	warm house	1
wasserstein	wasserstein	1
weston	weston	1
whirlpool	whirlpool	1
whynter	whynter	1
kitchen	kitchen	1
bedroom	bedroom	1
bathroom	bathroom	1
lobby	lobby	1
living room	living room	1
livingroom	livingroom	1
restroom	restroom	1
toilet	toilet	1
dining room	dining room	1
diningroom	diningroom	1
corridor	corridor	1
drawing room	drawing room	1
garden	garden	1
study room	study room	1
garage	garage	1
apartment	apartment	1
porch	porch	1
loft	loft	1
stair	stair	1
staircase	staircase	1
stir well	stir well	1
entrance	entrance	1
sitting room	sitting room	1
meeting room	meeting room	1
office	office	1
master bedroom	master bedroom	1
quest bedroom	quest bedroom	1
children bedroom	children bedroom	1
dressing room	dressing room	1
storeroom	storeroom	1
store room	store room	1
basement	basement	1
undercroft	undercroft	1
master bathroom	master bathroom	1
wash room	wash room	1
aisle	aisle	1
lounge	lounge	1
bar	bar	1
balcony	balcony	1
gallery	gallery	1
