job title	job title	1
superintendent of schools	superintendent of schools	1
chief , fire department	chief , fire department	1
dep chf of dept -lrb- fire dept -rrb-	dep chf of dept -lrb- fire dept -rrb-	1
assistant law librarian	assistant law librarian	1
law librarian	law librarian	1
bookbinder	bookbinder	1
chief of police	chief of police	1
assistant chief of police	assistant chief of police	1
member , board of supervisors	member , board of supervisors	1
mayoral staff ii	mayoral staff ii	1
mayoral staff iv	mayoral staff iv	1
mayoral staff v	mayoral staff v	1
mayoral staff vi	mayoral staff vi	1
mayoral staff vii	mayoral staff vii	1
mayoral staff ix	mayoral staff ix	1
mayoral staff x	mayoral staff x	1
mayoral staff xi	mayoral staff xi	1
mayoral staff xii	mayoral staff xii	1
mayoral staff xiii	mayoral staff xiii	1
mayoral staff xiv	mayoral staff xiv	1
mayoral staff xv	mayoral staff xv	1
mayoral staff xvi	mayoral staff xvi	1
mayoral staff xvii	mayoral staff xvii	1
manager i	manager i	1
manager ii	manager ii	1
manager iii	manager iii	1
manager iv	manager iv	1
manager v	manager v	1
manager vi	manager vi	1
manager vii	manager vii	1
manager viii	manager viii	1
dep dir i	dep dir i	1
dep dir ii	dep dir ii	1
dep dir iii	dep dir iii	1
dep dir iv	dep dir iv	1
dep dir v	dep dir v	1
dept head i	dept head i	1
dept head ii	dept head ii	1
dept head iii	dept head iii	1
dept head iv	dept head iv	1
dept head v	dept head v	1
is operator-journey	is operator-journey	1
is operator-senior	is operator-senior	1
is operator-analyst	is operator-analyst	1
is technician assistant	is technician assistant	1
is technical-journey	is technical-journey	1
is technician-senior	is technician-senior	1
is technician-supervisor	is technician-supervisor	1
is administrator 1	is administrator 1	1
is administrator-supervisor	is administrator-supervisor	1
is trainer-assistant	is trainer-assistant	1
is trainer-journey	is trainer-journey	1
is trainer-senior	is trainer-senior	1
is engineer-assistant	is engineer-assistant	1
is engineer-journey	is engineer-journey	1
is engineer-senior	is engineer-senior	1
is engineer-principal	is engineer-principal	1
is business analyst-assistant	is business analyst-assistant	1
is business analyst	is business analyst	1
is business analyst-senior	is business analyst-senior	1
is business analyst-principal	is business analyst-principal	1
is program analyst-assistant	is program analyst-assistant	1
is programmer analyst	is programmer analyst	1
is programmer analyst-senior	is programmer analyst-senior	1
is prg analyst-principal	is prg analyst-principal	1
is project director	is project director	1
is manager	is manager	1
dep dir for investments , ret	dep dir for investments , ret	1
youth comm advisor	youth comm advisor	1
ex asst to admin , sfgh	ex asst to admin , sfgh	1
adm , sfgh medical center	adm , sfgh medical center	1
mayor	mayor	1
personnel clerk	personnel clerk	1
personnel technician	personnel technician	1
senior personnel clerk	senior personnel clerk	1
benefits technician	benefits technician	1
benefits analyst	benefits analyst	1
payroll supervisor	payroll supervisor	1
payroll clerk	payroll clerk	1
sr payroll & personnel clerk	sr payroll & personnel clerk	1
pr payroll & personnel clerk	pr payroll & personnel clerk	1
chf payroll & personnel clerk	chf payroll & personnel clerk	1
testing technician	testing technician	1
assistant manager , eeo	assistant manager , eeo	1
training officer	training officer	1
eeo programs specialist	eeo programs specialist	1
training coordinator	training coordinator	1
personnel analyst	personnel analyst	1
senior personnel analyst	senior personnel analyst	1
principal personnel analyst	principal personnel analyst	1
employee relations representat	employee relations representat	1
senior emp relations repres	senior emp relations repres	1
manager , employee relations div	manager , employee relations div	1
dir emp relations div	dir emp relations div	1
human resources director	human resources director	1
public relations assistant	public relations assistant	1
public information officer	public information officer	1
public relations officer	public relations officer	1
customer service agent	customer service agent	1
customer service agent supv	customer service agent supv	1
special assistant 1	special assistant 1	1
junior clerk	junior clerk	1
elections clerk	elections clerk	1
clerk	clerk	1
senior clerk	senior clerk	1
principal clerk	principal clerk	1
chief clerk	chief clerk	1
junior clerk typist	junior clerk typist	1
clerk typist	clerk typist	1
senior clerk typist	senior clerk typist	1
unit clerk	unit clerk	1
nurses staffing assistant	nurses staffing assistant	1
transcriber typist	transcriber typist	1
senior unit clerk	senior unit clerk	1
senior transcriber typist	senior transcriber typist	1
shelter service representative	shelter service representative	1
shelter officer supervisor	shelter officer supervisor	1
braillist	braillist	1
shelter office asst supv	shelter office asst supv	1
medical transcriber typist	medical transcriber typist	1
sr medical transcriber typist	sr medical transcriber typist	1
secretary 1	secretary 1	1
executive secretary 1	executive secretary 1	1
legal secretary 1	legal secretary 1	1
meter reader	meter reader	1
water services clerk	water services clerk	1
elections worker	elections worker	1
claims process clerk	claims process clerk	1
senior water services clerk	senior water services clerk	1
principal water services clerk	principal water services clerk	1
asst clk , board of supervisors	asst clk , board of supervisors	1
cfdntal sctry & ex asst publdfdr	cfdntal sctry & ex asst publdfdr	1
confidential sctry to assessor	confidential sctry to assessor	1
cfdntal sctry to distric atty	cfdntal sctry to distric atty	1
cfdntal sctry to city atty	cfdntal sctry to city atty	1
secretary , comm on the environ	secretary , comm on the environ	1
secretary , library commission	secretary , library commission	1
sctry , human svcs . commission	sctry , human svcs . commission	1
sctry , juv probation comm	sctry , juv probation comm	1
secretary , health commission	secretary , health commission	1
sctry , bldg inspection comm	sctry , bldg inspection comm	1
ex asst to the controller	ex asst to the controller	1
account clerk	account clerk	1
senior account clerk	senior account clerk	1
principal account clerk	principal account clerk	1
health care billing clerk 1	health care billing clerk 1	1
patient accounts clerk	patient accounts clerk	1
accountant intern	accountant intern	1
accountant i	accountant i	1
accountant ii	accountant ii	1
accountant iii	accountant iii	1
accountant iv	accountant iv	1
patient accounts asst sprv	patient accounts asst sprv	1
patient accounts supervisor	patient accounts supervisor	1
patient accounts manager	patient accounts manager	1
financial systems supervisor	financial systems supervisor	1
auditor ii	auditor ii	1
auditor iii	auditor iii	1
communications dispatcher 1	communications dispatcher 1	1
telephone operator	telephone operator	1
senior telephone operator	senior telephone operator	1
senior data entry operator	senior data entry operator	1
microphoto/imaging technician	microphoto/imaging technician	1
sr. . microphoto/imaging tech .	sr. . microphoto/imaging tech .	1
offset machine operator	offset machine operator	1
senior offset machine operator	senior offset machine operator	1
mail & reproduction svc sprv	mail & reproduction svc sprv	1
media production tech	media production tech	1
media programming spec	media programming spec	1
media production supv	media production supv	1
photographer	photographer	1
media production specialist	media production specialist	1
media training specialist	media training specialist	1
head photographer	head photographer	1
media/security sys spec	media/security sys spec	1
media/security syst supv	media/security syst supv	1
research assistant	research assistant	1
performance analyst i	performance analyst i	1
statistician	statistician	1
performance analyst ii	performance analyst ii	1
senior statistician	senior statistician	1
assistant retirement analyst	assistant retirement analyst	1
senior benefits analyst	senior benefits analyst	1
benefits supervisor	benefits supervisor	1
junior administrative analyst	junior administrative analyst	1
administrative analyst	administrative analyst	1
senior administrative analyst	senior administrative analyst	1
pr administrative analyst	pr administrative analyst	1
prnpl admin analyst ii	prnpl admin analyst ii	1
administrative services mgr	administrative services mgr	1
legislative assistant	legislative assistant	1
water conservation admin	water conservation admin	1
junior management assistant	junior management assistant	1
management assistant	management assistant	1
ex dir , se com fac comm	ex dir , se com fac comm	1
senior management assistant	senior management assistant	1
prog mgr , bus & econ develop	prog mgr , bus & econ develop	1
auditor i	auditor i	1
inventory clerk	inventory clerk	1
senior inventory clerk	senior inventory clerk	1
materials/supplies supervisor	materials/supplies supervisor	1
sr materials & supplies sprv	sr materials & supplies sprv	1
parts storekeeper	parts storekeeper	1
warehouse worker	warehouse worker	1
senior parts storekeeper	senior parts storekeeper	1
assistant storekeeper	assistant storekeeper	1
storekeeper	storekeeper	1
principal parts storekeeper	principal parts storekeeper	1
senior storekeeper	senior storekeeper	1
supervising parts storekeeper	supervising parts storekeeper	1
stores & equip asst sprv	stores & equip asst sprv	1
asst materials coordinator	asst materials coordinator	1
materials coordinator	materials coordinator	1
assistant purchaser	assistant purchaser	1
purchaser	purchaser	1
senior purchaser	senior purchaser	1
supervising purchaser	supervising purchaser	1
patient svcs finance tech	patient svcs finance tech	1
med staff svcs dept spc	med staff svcs dept spc	1
med staff svcs dept anl	med staff svcs dept anl	1
medical records clerk	medical records clerk	1
medical records technician	medical records technician	1
medical records tech sprv	medical records tech sprv	1
health care analyst	health care analyst	1
hospital assoc administrator	hospital assoc administrator	1
dental aide	dental aide	1
dental hygienist	dental hygienist	1
dentist	dentist	1
physician assistant	physician assistant	1
physician specialist	physician specialist	1
senior physician specialist	senior physician specialist	1
supervising physician spec	supervising physician spec	1
medical dir , dept of health	medical dir , dept of health	1
asst dir of clinical svcs 1	asst dir of clinical svcs 1	1
post m.d. 1	post m.d. 1	1
shelter veterinarian	shelter veterinarian	1
nursing assistant	nursing assistant	1
patient care assistant	patient care assistant	1
psychiatric technician	psychiatric technician	1
senior psychiatric orderly	senior psychiatric orderly	1
surgical procedures technician	surgical procedures technician	1
licensed vocational nurse	licensed vocational nurse	1
public health team leader	public health team leader	1
registered nurse	registered nurse	1
nurse manager	nurse manager	1
clinical nurse specialist	clinical nurse specialist	1
nursing supervisor	nursing supervisor	1
nurse midwife	nurse midwife	1
nursing supervisor psychiatric	nursing supervisor psychiatric	1
nurse practitioner	nurse practitioner	1
anesthetist	anesthetist	1
operating room nurse	operating room nurse	1
central processing & dist tech	central processing & dist tech	1
sr cent proc & dist tech	sr cent proc & dist tech	1
laboratory helper	laboratory helper	1
forensic laboratory technician	forensic laboratory technician	1
pharmacy helper	pharmacy helper	1
senior pharmacy helper	senior pharmacy helper	1
pharmacy technician	pharmacy technician	1
bacteriological lab assistant	bacteriological lab assistant	1
x-ray laboratory aide	x-ray laboratory aide	1
medical evaluations assistant	medical evaluations assistant	1
electroencephalograph tech 1	electroencephalograph tech 1	1
vet laboratory technologist	vet laboratory technologist	1
pharmacist	pharmacist	1
supervising pharmacist	supervising pharmacist	1
clinical pharmacist	clinical pharmacist	1
asst forensic toxicologist 1	asst forensic toxicologist 1	1
forensic toxicologist	forensic toxicologist	1
microbiologist	microbiologist	1
senior microbiologist	senior microbiologist	1
chief microbiologist	chief microbiologist	1
diagnostic imaging tech i	diagnostic imaging tech i	1
diagnostic imaging tech ii	diagnostic imaging tech ii	1
diagnostic imaging tech iii	diagnostic imaging tech iii	1
diagnostic imaging tech iv	diagnostic imaging tech iv	1
water qualitytech i/ii	water qualitytech i/ii	1
water quality tech iii	water quality tech iii	1
biologist i/ii	biologist i/ii	1
biologist iii	biologist iii	1
supv biologist	supv biologist	1
chemist i/ii	chemist i/ii	1
chemist iii	chemist iii	1
supv chemist	supv chemist	1
lab svcs mgr	lab svcs mgr	1
radiologic tech sprv	radiologic tech sprv	1
orthopedic technician 1	orthopedic technician 1	1
morgue attendant	morgue attendant	1
senior morgue attendant	senior morgue attendant	1
forensic autopsy technician	forensic autopsy technician	1
emergency med svcs agency spec	emergency med svcs agency spec	1
respiratory care practitioner	respiratory care practitioner	1
audiometrist	audiometrist	1
audiologist	audiologist	1
speech pathologist	speech pathologist	1
occupational therapist	occupational therapist	1
senior occupational therapist	senior occupational therapist	1
mental hlth treatment spec	mental hlth treatment spec	1
dir of act , therapy & vol svcs	dir of act , therapy & vol svcs	1
therapy aide	therapy aide	1
physical therapist assistant	physical therapist assistant	1
physical therapist	physical therapist	1
senior physical therapist	senior physical therapist	1
optometrist	optometrist	1
acupuncturist	acupuncturist	1
rehabilitation counselor	rehabilitation counselor	1
clinical psychologist	clinical psychologist	1
research psychologist	research psychologist	1
sprv clincal psychologist	sprv clincal psychologist	1
med examiner 's investigator i	med examiner 's investigator i	1
med examiner 's investigator ii	med examiner 's investigator ii	1
med examiner 's investigatoriii	med examiner 's investigatoriii	1
home health aide	home health aide	1
health worker 1	health worker 1	1
health program coordinator 1	health program coordinator 1	1
employee assistance counselor	employee assistance counselor	1
sr employee asst counselor	sr employee asst counselor	1
asst med examiner	asst med examiner	1
food service worker	food service worker	1
senior food service worker	senior food service worker	1
supply room attendant	supply room attendant	1
food service supervisor	food service supervisor	1
senior food service supervisor	senior food service supervisor	1
food service mgr administrator	food service mgr administrator	1
dietetic technician	dietetic technician	1
dietitian	dietitian	1
chief dietitian	chief dietitian	1
assistant cook	assistant cook	1
baker	baker	1
cook	cook	1
chef	chef	1
housekeeper/food service clnr	housekeeper/food service clnr	1
custodian	custodian	1
custodial assistant supervisor	custodial assistant supervisor	1
custodial supervisor	custodial supervisor	1
janitorial svcs asst sprv	janitorial svcs asst sprv	1
janitorial services supervisor	janitorial services supervisor	1
porter	porter	1
porter assistant supervisor	porter assistant supervisor	1
porter supervisor 1	porter supervisor 1	1
senior laundry worker	senior laundry worker	1
sewing technician	sewing technician	1
asst general services manager	asst general services manager	1
general services manager	general services manager	1
epidemiologist 1	epidemiologist 1	1
disease control investigator	disease control investigator	1
sr disease control invstgtor	sr disease control invstgtor	1
health program planner	health program planner	1
assistant health educator	assistant health educator	1
senior health program planner	senior health program planner	1
health educator	health educator	1
senior health educator	senior health educator	1
public health nurse	public health nurse	1
nutritionist	nutritionist	1
eligibility worker	eligibility worker	1
human services technician	human services technician	1
senior eligibility worker	senior eligibility worker	1
eligibility worker supervisor	eligibility worker supervisor	1
hospital eligiblity worker	hospital eligiblity worker	1
hospital elig wrk supervisor	hospital elig wrk supervisor	1
social worker	social worker	1
senior social worker	senior social worker	1
program specialist	program specialist	1
social work supervisor	social work supervisor	1
program specialist supervisor	program specialist supervisor	1
social work specialist	social work specialist	1
program support analyst	program support analyst	1
medical social worker	medical social worker	1
senior medical social worker	senior medical social worker	1
medical social work supervisor	medical social work supervisor	1
psychiatric social worker	psychiatric social worker	1
marriage , family & child cnslr	marriage , family & child cnslr	1
sr psychiatric social worker	sr psychiatric social worker	1
conservatorship/case mgt sprv	conservatorship/case mgt sprv	1
sr marriage , fam & cld cnslr	sr marriage , fam & cld cnslr	1
protective services worker	protective services worker	1
protective services supervisor	protective services supervisor	1
hospital eligibility mgr , dph	hospital eligibility mgr , dph	1
welfare fraud investigator	welfare fraud investigator	1
sup welfare fraud investigator	sup welfare fraud investigator	1
citizens complaint officer	citizens complaint officer	1
rent board supervisor	rent board supervisor	1
coord , human rights comm	coord , human rights comm	1
contract compliance officer 1	contract compliance officer 1	1
rep , human rights comm	rep , human rights comm	1
rep , comm status of women	rep , comm status of women	1
secretary , rec and park comm .	secretary , rec and park comm .	1
locker room attendant	locker room attendant	1
swimming instr/pool lifeguard	swimming instr/pool lifeguard	1
senior swimming instructor	senior swimming instructor	1
dance instructor	dance instructor	1
photography instructor	photography instructor	1
crafts instructor	crafts instructor	1
assistant recreation director	assistant recreation director	1
recreation director	recreation director	1
asst recreation supervisor	asst recreation supervisor	1
asst superintendent rec	asst superintendent rec	1
admission attendant	admission attendant	1
stable attendant	stable attendant	1
animal keeper	animal keeper	1
senior animal keeper	senior animal keeper	1
zoo curator	zoo curator	1
animal care attendant	animal care attendant	1
animal care supervisor	animal care supervisor	1
animal control officer	animal control officer	1
volunteer/outreach coord	volunteer/outreach coord	1
animal health technician	animal health technician	1
animal care asst supv	animal care asst supv	1
field svcs asst supv	field svcs asst supv	1
farmer	farmer	1
gardener	gardener	1
municipal stadium groundskpr	municipal stadium groundskpr	1
park section supervisor	park section supervisor	1
pest control specialist	pest control specialist	1
forester	forester	1
nursery specialist	nursery specialist	1
chief nursery specialist	chief nursery specialist	1
arborist technician	arborist technician	1
urban forestry inspector	urban forestry inspector	1
arborist technician supervisor	arborist technician supervisor	1
agricultural inspector	agricultural inspector	1
watershed forester	watershed forester	1
assoc musm cnsrvt , aam	assoc musm cnsrvt , aam	1
museum preparator	museum preparator	1
senior museum preparator	senior museum preparator	1
principal museum preparator	principal museum preparator	1
chief preparator	chief preparator	1
curator 1	curator 1	1
arts program assistant	arts program assistant	1
associate museum registrar	associate museum registrar	1
museum registrar	museum registrar	1
senior museum registrar	senior museum registrar	1
library page	library page	1
library assistant	library assistant	1
library technical assistant 1	library technical assistant 1	1
librarian 1	librarian 1	1
performing arts center aide	performing arts center aide	1
real property manager	real property manager	1
senior real property officer	senior real property officer	1
principal real property ofc	principal real property ofc	1
assessment srvcs office spec	assessment srvcs office spec	1
sr asmnt srvcs office spec	sr asmnt srvcs office spec	1
personal property auditor	personal property auditor	1
sr personal property auditor	sr personal property auditor	1
pr personal property auditor	pr personal property auditor	1
estate investigator	estate investigator	1
senior estate investigator	senior estate investigator	1
real prop appraiser trainee	real prop appraiser trainee	1
real property appraiser	real property appraiser	1
senior real property appraiser	senior real property appraiser	1
pr real property appraiser	pr real property appraiser	1
assessor	assessor	1
collections officer	collections officer	1
senior collections officer	senior collections officer	1
commercial div asst sprv	commercial div asst sprv	1
cashier 1	cashier 1	1
security analyst	security analyst	1
investigator , tax collector	investigator , tax collector	1
sr investigator , tax collector	sr investigator , tax collector	1
collection supervisor	collection supervisor	1
treasurer	treasurer	1
architectural administrator	architectural administrator	1
sewage treatment plant supt	sewage treatment plant supt	1
water operations analyst	water operations analyst	1
supt water treatment fac	supt water treatment fac	1
administrative engineer	administrative engineer	1
safety officer	safety officer	1
junior engineer	junior engineer	1
asst engr	asst engr	1
assoc engineer	assoc engineer	1
eng/arch/landscape arch sr	eng/arch/landscape arch sr	1
engineer/architect principal	engineer/architect principal	1
building plans engineer	building plans engineer	1
fire protection engineer	fire protection engineer	1
chief surveyor	chief surveyor	1
structural engineer	structural engineer	1
engineer	engineer	1
radio engineer	radio engineer	1
architectural assistant 1	architectural assistant 1	1
landscape architect assoc 1	landscape architect assoc 1	1
airport noise abatement spec	airport noise abatement spec	1
architectural associate 1	architectural associate 1	1
architect	architect	1
sr airport noise abatement spe	sr airport noise abatement spe	1
landscape architect	landscape architect	1
planner 1	planner 1	1
transit planner iii	transit planner iii	1
planner 3-environmental review	planner 3-environmental review	1
planner 4-environmental review	planner 4-environmental review	1
manager , traffic painting prog	manager , traffic painting prog	1
traffic survey technician	traffic survey technician	1
sprv , traffic & street signs	sprv , traffic & street signs	1
materials testing aide	materials testing aide	1
materials testing technician	materials testing technician	1
traffic sign manager	traffic sign manager	1
survey assistant i	survey assistant i	1
survey assistant ii	survey assistant ii	1
survey associate	survey associate	1
illustrator and art designer	illustrator and art designer	1
graphic artist	graphic artist	1
graphics supervisor	graphics supervisor	1
mechanical eng associate 1	mechanical eng associate 1	1
engineering assistant	engineering assistant	1
engineering associate 1	engineering associate 1	1
stdntdsgntrain1 , arch/eng/plng	stdntdsgntrain1 , arch/eng/plng	1
stdntdsgn train2/arch/eng / plng	stdntdsgn train2/arch/eng / plng	1
stdntdsgntrain3 , arch/eng/plng	stdntdsgntrain3 , arch/eng/plng	1
coord of citizen involvement	coord of citizen involvement	1
project manager 1	project manager 1	1
utility analyst	utility analyst	1
utility specialist	utility specialist	1
regulatory specialist	regulatory specialist	1
environmental assistant	environmental assistant	1
environmental spec	environmental spec	1
sr. . environmental spec	sr. . environmental spec	1
principal environ specialist	principal environ specialist	1
environmental hlth tech 1	environmental hlth tech 1	1
wastewater control inspector	wastewater control inspector	1
sprv wastewater cont inspector	sprv wastewater cont inspector	1
environmental health inspector	environmental health inspector	1
sr environmental hlth insp	sr environmental hlth insp	1
pr environmental hlth insp	pr environmental hlth insp	1
safety analyst	safety analyst	1
assistant industrial hygienist	assistant industrial hygienist	1
industrial hygienist	industrial hygienist	1
senior industrial hygienist	senior industrial hygienist	1
inspector , weights & measures	inspector , weights & measures	1
street inspector	street inspector	1
senior street inspector	senior street inspector	1
street inspection supervisor	street inspection supervisor	1
heating/ventilating inspector	heating/ventilating inspector	1
plumbing inspector	plumbing inspector	1
chief plumbing inspector	chief plumbing inspector	1
senior plumbing inspector	senior plumbing inspector	1
electrical inspector	electrical inspector	1
senior electrical inpsector	senior electrical inpsector	1
chief electrical inspector	chief electrical inspector	1
line inspector	line inspector	1
plan checker	plan checker	1
senior plan checker	senior plan checker	1
housing inspector	housing inspector	1
senior housing inspector	senior housing inspector	1
chief housing inspector	chief housing inspector	1
assistant const inspector	assistant const inspector	1
construction inspector	construction inspector	1
senior const inspector	senior const inspector	1
building inspector	building inspector	1
senior building inspector	senior building inspector	1
chief building inspector	chief building inspector	1
disability access coordinator	disability access coordinator	1
heavy equip ops asst sprv	heavy equip ops asst sprv	1
mobile equipment asst sprv	mobile equipment asst sprv	1
bldgs & grounds maint supt	bldgs & grounds maint supt	1
mech shop & equip supt	mech shop & equip supt	1
telecommunication supervisor	telecommunication supervisor	1
water const & main supt	water const & main supt	1
bldg & grounds maint sprv	bldg & grounds maint sprv	1
chief water service inspector	chief water service inspector	1
chief stationary engineer	chief stationary engineer	1
heavy equipment ops sprv	heavy equipment ops sprv	1
mobile equipment supervisor	mobile equipment supervisor	1
plumber supervisor 1	plumber supervisor 1	1
general laborer supervisor 1	general laborer supervisor 1	1
electrical trnst shop sprv 1	electrical trnst shop sprv 1	1
maintenance scheduler	maintenance scheduler	1
asphalt finisher supervisor 1	asphalt finisher supervisor 1	1
asphalt plant supervisor 1	asphalt plant supervisor 1	1
cable machinery supervisor	cable machinery supervisor	1
transit paint shop sprv1	transit paint shop sprv1	1
carpenter supervisor 1	carpenter supervisor 1	1
cement finisher supervisor 1	cement finisher supervisor 1	1
automotive trnst shop sprv 1	automotive trnst shop sprv 1	1
transmission line supervisor 1	transmission line supervisor 1	1
glazier supervisor 1	glazier supervisor 1	1
transit power line sprv1	transit power line sprv1	1
locksmith supervisor 1	locksmith supervisor 1	1
electrician supervisor 1	electrician supervisor 1	1
water meter shop supervisor 1	water meter shop supervisor 1	1
senior maintenance controller	senior maintenance controller	1
painter supervisor 1	painter supervisor 1	1
parking meter repairer sprv 1	parking meter repairer sprv 1	1
power plant supervisor 1	power plant supervisor 1	1
chf statnry eng , wtrtreat plnt	chf statnry eng , wtrtreat plnt	1
sewer repair supervisor	sewer repair supervisor	1
automotive mechanic sprv 1	automotive mechanic sprv 1	1
utility plumber supervisor 1	utility plumber supervisor 1	1
track maint wrk sprv 1	track maint wrk sprv 1	1
chf stationary eng , sew plant	chf stationary eng , sew plant	1
electrical trnst mech sprv 1	electrical trnst mech sprv 1	1
automotive machinist sprv 1	automotive machinist sprv 1	1
power house electrician sprv 1	power house electrician sprv 1	1
electric motor repair sprv 1	electric motor repair sprv 1	1
communication line sprv1	communication line sprv1	1
maintenance machinist sprv 1	maintenance machinist sprv 1	1
water & power maint sprv 1	water & power maint sprv 1	1
maintenance planner	maintenance planner	1
maintenance manager	maintenance manager	1
auto body & fender wrk sprv 1	auto body & fender wrk sprv 1	1
window cleaner supervisor	window cleaner supervisor	1
watershed keeper supervisor	watershed keeper supervisor	1
telecommunications tech supv	telecommunications tech supv	1
city shops asst superintendent	city shops asst superintendent	1
street environ svcs oprs supv	street environ svcs oprs supv	1
wire rope cable maint sprv	wire rope cable maint sprv	1
sprv electronic main tech	sprv electronic main tech	1
metal fabricator	metal fabricator	1
automotive body & fender wrk	automotive body & fender wrk	1
bricklayer	bricklayer	1
cable splicer	cable splicer	1
car and auto painter	car and auto painter	1
cement mason	cement mason	1
automotive machinist	automotive machinist	1
auto machinist asst sprv	auto machinist asst sprv	1
water service inspector	water service inspector	1
senior water service inspector	senior water service inspector	1
electronic maintenance tech	electronic maintenance tech	1
electric motor repairer	electric motor repairer	1
auto body & fender wrk asst sprv	auto body & fender wrk asst sprv	1
beautician	beautician	1
general utility mechanic	general utility mechanic	1
glazier	glazier	1
operating engineer , universal	operating engineer , universal	1
electr maint tech asst sprv	electr maint tech asst sprv	1
sr general utility mechanic	sr general utility mechanic	1
maintenance machinist	maintenance machinist	1
apprentice stationary engineer	apprentice stationary engineer	1
stationary engineer	stationary engineer	1
senior stationary engineer	senior stationary engineer	1
electr instrmntn tech wtr poll	electr instrmntn tech wtr poll	1
main machinist asst sprv	main machinist asst sprv	1
electrical line worker	electrical line worker	1
aprntcstatnry eng , wtrtreatplnt	aprntcstatnry eng , wtrtreatplnt	1
maintenance controller	maintenance controller	1
statnry eng water treat plant	statnry eng water treat plant	1
locksmith	locksmith	1
sr statnry eng , wtr treat plnt	sr statnry eng , wtr treat plnt	1
carpenter	carpenter	1
electrician	electrician	1
painter	painter	1
plumber	plumber	1
steamfitter	steamfitter	1
steamfitter supervisor i	steamfitter supervisor i	1
water meter repairer	water meter repairer	1
truck driver	truck driver	1
pattern maker	pattern maker	1
pipe welder	pipe welder	1
communications systems tech	communications systems tech	1
power house operator	power house operator	1
senior power house operator	senior power house operator	1
electronic control sys tech	electronic control sys tech	1
senior comm systems technican	senior comm systems technican	1
rigger	rigger	1
electrical transit system mech	electrical transit system mech	1
stationary eng , sewage plant	stationary eng , sewage plant	1
sr. . stationary eng , sew plant	sr. . stationary eng , sew plant	1
aprntc statnry eng , sew plant	aprntc statnry eng , sew plant	1
sheet metal worker	sheet metal worker	1
stage electrician	stage electrician	1
tile setter	tile setter	1
electrl trnst mech , asst sprv	electrl trnst mech , asst sprv	1
automotive mechanic	automotive mechanic	1
automotive mechanic asst sprv	automotive mechanic asst sprv	1
utility plumber	utility plumber	1
metalsmith	metalsmith	1
welder	welder	1
window cleaner	window cleaner	1
soft floor coverer	soft floor coverer	1
ornamental iron worker	ornamental iron worker	1
asphalt finisher	asphalt finisher	1
assistant power house operator	assistant power house operator	1
automotive service worker	automotive service worker	1
auto svc wrk asst sprv	auto svc wrk asst sprv	1
book repairer	book repairer	1
senior book repairer	senior book repairer	1
sewer maintenance worker	sewer maintenance worker	1
dryer mixer operator	dryer mixer operator	1
hodcarrier	hodcarrier	1
asst electronic main tech	asst electronic main tech	1
electrical line helper	electrical line helper	1
maintenance machinist helper	maintenance machinist helper	1
parking meter repairer	parking meter repairer	1
sewer service worker	sewer service worker	1
shade and drapery worker	shade and drapery worker	1
traffic signal operator	traffic signal operator	1
sign worker	sign worker	1
switch repairer	switch repairer	1
watershed keeper	watershed keeper	1
wire rope cable maint mechanic	wire rope cable maint mechanic	1
sr power generation tech	sr power generation tech	1
power generation supervisor	power generation supervisor	1
environmental service worker	environmental service worker	1
asphalt worker	asphalt worker	1
lighting fixture maint worker	lighting fixture maint worker	1
general laborer	general laborer	1
institution utility worker	institution utility worker	1
track maintenance worker	track maintenance worker	1
victim & witness technician	victim & witness technician	1
legal process clerk	legal process clerk	1
asr office assistant	asr office assistant	1
senior legal process clerk	senior legal process clerk	1
document examiner technician	document examiner technician	1
recordable docs office spec	recordable docs office spec	1
sr recordable docs office spec	sr recordable docs office spec	1
court clerk	court clerk	1
legislative calendar clerk	legislative calendar clerk	1
legislation clerk	legislation clerk	1
fare inspections supv/invest	fare inspections supv/invest	1
invstgtor ofc citizen cmplnts	invstgtor ofc citizen cmplnts	1
sr investigator , occ	sr investigator , occ	1
victim/witness investigator 1	victim/witness investigator 1	1
da investigative assist	da investigative assist	1
asst chf victim/wit invstgtor	asst chf victim/wit invstgtor	1
chf victim/witness invstgtor	chf victim/witness invstgtor	1
industrial injury investigator	industrial injury investigator	1
worker 's compensation adjuster	worker 's compensation adjuster	1
public defender 's investigator	public defender 's investigator	1
sr public defenders invstgtor	sr public defenders invstgtor	1
district attry 's investigator	district attry 's investigator	1
sr district atty investigator	sr district atty investigator	1
chf district atty investigator	chf district atty investigator	1
asst chf dist atty 's invstgtor	asst chf dist atty 's invstgtor	1
pr distatty invstgtor , specunit	pr distatty invstgtor , specunit	1
claims investigator , ca	claims investigator , ca	1
srclaimsinvstgtor , cty atty ofc	srclaimsinvstgtor , cty atty ofc	1
pr clm invstgtr , city atty ofc	pr clm invstgtr , city atty ofc	1
child support officer ii	child support officer ii	1
child support officer iii	child support officer iii	1
worker 's comp supervisor 1	worker 's comp supervisor 1	1
parking hearing examiner	parking hearing examiner	1
parking hearing supervisor	parking hearing supervisor	1
legislative asst city atty ofc	legislative asst city atty ofc	1
legal assistant	legal assistant	1
attorney -lrb- civil/criminal -rrb-	attorney -lrb- civil/criminal -rrb-	1
assistant chief attorney 1	assistant chief attorney 1	1
head atty , civil & criminal	head atty , civil & criminal	1
attorney , tax collector	attorney , tax collector	1
chief atty1 -lrb- civil & criminal -rrb-	chief atty1 -lrb- civil & criminal -rrb-	1
public defender	public defender	1
city attorney	city attorney	1
district attorney	district attorney	1
security guard	security guard	1
institutional police officer	institutional police officer	1
institutional police sergeant	institutional police sergeant	1
bldg & grounds patrol officer	bldg & grounds patrol officer	1
park patrol officer	park patrol officer	1
institutional police lieut	institutional police lieut	1
head park patrol officer	head park patrol officer	1
police services aide	police services aide	1
parking control officer	parking control officer	1
senior parking control officer	senior parking control officer	1
comm pol svcs aide supervisor	comm pol svcs aide supervisor	1
parking enforcement admin	parking enforcement admin	1
museum guard	museum guard	1
museum sec supv	museum sec supv	1
fire alarm dispatcher	fire alarm dispatcher	1
chief fire alarm dispatcher	chief fire alarm dispatcher	1
police communications disp	police communications disp	1
sr pol communications disp	sr pol communications disp	1
pub safety communication coord	pub safety communication coord	1
emergency planning coordinator	emergency planning coordinator	1
fingerprint technician 1	fingerprint technician 1	1
criminalist i	criminalist i	1
criminalist ii	criminalist ii	1
criminalist iii	criminalist iii	1
forensic document examiner	forensic document examiner	1
police cadet	police cadet	1
sheriff 's cadet	sheriff 's cadet	1
deputy sheriff 1	deputy sheriff 1	1
deputy sheriff	deputy sheriff	1
senior deputy sheriff	senior deputy sheriff	1
sheriff 's sergeant	sheriff 's sergeant	1
sheriff 's lieutenant	sheriff 's lieutenant	1
sheriff 's captain	sheriff 's captain	1
chief deputy sheriff	chief deputy sheriff	1
assistant sheriff	assistant sheriff	1
counselor , juvenile hall	counselor , juvenile hall	1
counselor , log cabin ranch	counselor , log cabin ranch	1
sr counselor , juvenile hall	sr counselor , juvenile hall	1
sprv counselor , juvenile court	sprv counselor , juvenile court	1
asst dir , log cabin rnch	asst dir , log cabin rnch	1
director , log cabin ranch	director , log cabin ranch	1
asst director , juvenile hall	asst director , juvenile hall	1
undersheriff	undersheriff	1
sheriff	sheriff	1
sprv prob ofc , juv court	sprv prob ofc , juv court	1
sr sprv prob ofc , juv prob	sr sprv prob ofc , juv prob	1
director , probation services	director , probation services	1
rehabilitation svcs coord	rehabilitation svcs coord	1
sprv adult probation ofc	sprv adult probation ofc	1
div director , adult probation	div director , adult probation	1
chief adult probation officer	chief adult probation officer	1
chief deputy adlt probation of	chief deputy adlt probation of	1
deputy probation officer	deputy probation officer	1
court alternative specialist 1	court alternative specialist 1	1
transit car cleaner	transit car cleaner	1
transit car cleaner asst sprv	transit car cleaner asst sprv	1
fare collections receiver	fare collections receiver	1
sr fare collections receiver	sr fare collections receiver	1
pr fare collections receiver	pr fare collections receiver	1
transit revenue supervisor	transit revenue supervisor	1
transit information clerk	transit information clerk	1
sr transit information clerk	sr transit information clerk	1
transit traffic checker	transit traffic checker	1
senior transit traffic checker	senior transit traffic checker	1
station agent , muni railway	station agent , muni railway	1
transit fare inspector	transit fare inspector	1
transit supervisor	transit supervisor	1
transit manager 1	transit manager 1	1
train controller	train controller	1
claims investigator	claims investigator	1
senior claims investigator	senior claims investigator	1
claims adjuster	claims adjuster	1
transit operations specialist	transit operations specialist	1
transit operator	transit operator	1
manager ii , mta	manager ii , mta	1
manager iv , mta	manager iv , mta	1
manager i , mta	manager i , mta	1
manager iii , mta	manager iii , mta	1
manager v , mta	manager v , mta	1
manager vi , mta	manager vi , mta	1
manager vii , mta	manager vii , mta	1
manager viii , mta	manager viii , mta	1
deputy dir i , mta	deputy dir i , mta	1
chf opr ofc , publ transp dept	chf opr ofc , publ transp dept	1
gen mgr , public trnsp dept	gen mgr , public trnsp dept	1
deputy dir ii , mta	deputy dir ii , mta	1
board scty , mta	board scty , mta	1
light rail vehicle equip eng	light rail vehicle equip eng	1
sr light rail veh equip eng	sr light rail veh equip eng	1
signal and systems engineer	signal and systems engineer	1
airports communicatins disp	airports communicatins disp	1
sr airport communications disp	sr airport communications disp	1
airports communications sprv	airports communications sprv	1
airport property specialist 1	airport property specialist 1	1
community police services aide	community police services aide	1
airport safety officer	airport safety officer	1
airport operations supervisor	airport operations supervisor	1
airport custodial svcs sprv	airport custodial svcs sprv	1
airport mechanical maint sprv	airport mechanical maint sprv	1
airport electrician	airport electrician	1
airport electrician supervisor	airport electrician supervisor	1
head airport electrician	head airport electrician	1
airport emerg planning coord	airport emerg planning coord	1
public relations mgr	public relations mgr	1
asst to dir , public affairs	asst to dir , public affairs	1
airport economic planner	airport economic planner	1
pile worker	pile worker	1
piledriver engine operator	piledriver engine operator	1
piledriver supervisor 1	piledriver supervisor 1	1
ornamental iron wrk sprv 1	ornamental iron wrk sprv 1	1
roofer	roofer	1
roofer supervisor 1	roofer supervisor 1	1
sheet metal supervisor 1	sheet metal supervisor 1	1
fusion welder	fusion welder	1
elevator and crane technician	elevator and crane technician	1
wharfinger 1	wharfinger 1	1
crane mechanic supervisor	crane mechanic supervisor	1
market research spec , port	market research spec , port	1
feasibility analyst , port	feasibility analyst , port	1
govrnmt/publ affairs mgr	govrnmt/publ affairs mgr	1
senior property manager , port	senior property manager , port	1
maritime marketing repr	maritime marketing repr	1
property manager , port	property manager , port	1
port director	port director	1
permit and citation clerk	permit and citation clerk	1
snr permit and citation clerk	snr permit and citation clerk	1
prpl permit and citation clerk	prpl permit and citation clerk	1
trans safety specialist	trans safety specialist	1
community development asst	community development asst	1
community development spec	community development spec	1
sr. . community devl spc 1	sr. . community devl spc 1	1
public service trainee	public service trainee	1
public service aide-admin	public service aide-admin	1
public svc aide-public works	public svc aide-public works	1
ps aide to prof	ps aide to prof	1
ps aide health services	ps aide health services	1
executive contract employee	executive contract employee	1
assistant superintendent , rec	assistant superintendent , rec	1
grants associate	grants associate	1
fire rescue paramedic	fire rescue paramedic	1
firefighter	firefighter	1
firefighter/paramedic	firefighter/paramedic	1
insp , fire dept	insp , fire dept	1
invstgtor , fire dept	invstgtor , fire dept	1
incident support specialist	incident support specialist	1
lieutenant , fire suppression	lieutenant , fire suppression	1
lieut , fire prev	lieut , fire prev	1
lieut , fire invstgtn	lieut , fire invstgtn	1
lieut , division of training	lieut , division of training	1
captain , -lrb- fire department -rrb-	captain , -lrb- fire department -rrb-	1
capt , fire prev or fire invsgtn	capt , fire prev or fire invsgtn	1
ems captain	ems captain	1
captain , division of training	captain , division of training	1
battlion chief , fire suppressi	battlion chief , fire suppressi	1
ems section chief	ems section chief	1
asst chf of dept -lrb- fire dept -rrb-	asst chf of dept -lrb- fire dept -rrb-	1
emergency medical svcs chief	emergency medical svcs chief	1
marine engineer of fire boats	marine engineer of fire boats	1
pilot of fire boats	pilot of fire boats	1
special nurse	special nurse	1
director of forensic services	director of forensic services	1
director of police psychology	director of police psychology	1
temporary position	temporary position	1
temporary position	temporary position	1
