aaron boone	aaron boone	1
aaron carter	aaron carter	1
aaron hernandez	aaron hernandez	1
aaron judge	aaron judge	1
acura	acura	1
airport protests	airport protests	1
al sharpton selfie	al sharpton selfie	1
american gods	american gods	1
apple crisps recipe	apple crisps recipe	1
april the giraffe	april the giraffe	1
atlanta falcons	atlanta falcons	1
australian cattle dog	australian cattle dog	1
australian shepherd	australian shepherd	1
baby driver	baby driver	1
bachelor in paradise	bachelor in paradise	1
bad and boujee	bad and boujee	1
beagle	beagle	1
beauty and the beast	beauty and the beast	1
beef stroganoff recipe	beef stroganoff recipe	1
big little lies	big little lies	1
bill o'reilly	bill o'reilly	1
bill paxton	bill paxton	1
bill skarsgård	bill skarsgård	1
bitcoin price	bitcoin price	1
bodak yellow	bodak yellow	1
border collie	border collie	1
boston celtics	boston celtics	1
boston free speech rally	boston free speech rally	1
buick	buick	1
bungee workout	bungee workout	1
burpees exercise	burpees exercise	1
cardi b	cardi b	1
carmelo anthony	carmelo anthony	1
cascara latte calories	cascara latte calories	1
c.f. monterrey	c.f. monterrey	1
charlie murphy	charlie murphy	1
charlottesville protests	charlottesville protests	1
chester bennington	chester bennington	1
chicken parmesan recipe	chicken parmesan recipe	1
chris cornell	chris cornell	1
coco	coco	1
coconut milk mocha macchiato calories	coconut milk mocha macchiato calories	1
corn casserole recipe	corn casserole recipe	1
daca	daca	1
dallas cowboys	dallas cowboys	1
danielle bregoli	danielle bregoli	1
david cassidy	david cassidy	1
despacito	despacito	1
dodge	dodge	1
duck face selfie	duck face selfie	1
dunkirk	dunkirk	1
eclipse selfie	eclipse selfie	1
ellen selfie	ellen selfie	1
fc barcelona	fc barcelona	1
fidget spinner	fidget spinner	1
floyd mayweather	floyd mayweather	1
ford	ford	1
french bulldog	french bulldog	1
gal gadot	gal gadot	1
game of thrones	game of thrones	1
get out	get out	1
goldendoodle	goldendoodle	1
golden retriever	golden retriever	1
gordon hayward	gordon hayward	1
grand mac calories	grand mac calories	1
gucci gang	gucci gang	1
hard boiled egg recipe	hard boiled egg recipe	1
harvey weinstein	harvey weinstein	1
hashbrown casserole recipe	hashbrown casserole recipe	1
heidi klum selfie	heidi klum selfie	1
hidden figures	hidden figures	1
hiit workout routine	hiit workout routine	1
honda	honda	1
houston astros	houston astros	1
houston rockets	houston rockets	1
how to buy bitcoin	how to buy bitcoin	1
how to freeze your credit	how to freeze your credit	1
how to make a fidget spinner	how to make a fidget spinner	1
how to make slime	how to make slime	1
how to make solar eclipse glasses	how to make solar eclipse glasses	1
how to screen record	how to screen record	1
how to solve a rubix cube	how to solve a rubix cube	1
how to watch mayweather vs mcgregor	how to watch mayweather vs mcgregor	1
how to watch the solar eclipse	how to watch the solar eclipse	1
hugh hefner	hugh hefner	1
humble .	humble .	1
hurricane harvey	hurricane harvey	1
hurricane irma	hurricane irma	1
hurricane jose	hurricane jose	1
hurricane maria	hurricane maria	1
hyundai	hyundai	1
inner thigh workout	inner thigh workout	1
iphone x	iphone x	1
iron fist	iron fist	1
isaiah thomas	isaiah thomas	1
it	it	1
jason aldean	jason aldean	1
jim nabors	jim nabors	1
joyner lucas	joyner lucas	1
justice league	justice league	1
kaia gerber selfie	kaia gerber selfie	1
kathy griffin	kathy griffin	1
kevin spacey	kevin spacey	1
kia	kia	1
lexus	lexus	1
lil peep	lil peep	1
lil pump	lil pump	1
linkin park	linkin park	1
lonzo ball	lonzo ball	1
look what you made me do	look what you made me do	1
los angeles dodgers	los angeles dodgers	1
louis c.k	louis c.k	1
mac jr calories	mac jr calories	1
maia campbell	maia campbell	1
mask off	mask off	1
matt lauer	matt lauer	1
may day protests	may day protests	1
mayweather vs mcgregor fight	mayweather vs mcgregor fight	1
mcdonalds ice cream cone calories	mcdonalds ice cream cone calories	1
meghan markle	meghan markle	1
melania trump	melania trump	1
meryl streep	meryl streep	1
michael flynn	michael flynn	1
millie bobby brown	millie bobby brown	1
milo yiannopoulos	milo yiannopoulos	1
moana	moana	1
monkey selfie	monkey selfie	1
montgomery gentry	montgomery gentry	1
murph crossfit workout	murph crossfit workout	1
naked chicken chalupa calories	naked chicken chalupa calories	1
new york yankees	new york yankees	1
nfl national anthem protests	nfl national anthem protests	1
nia jax selfie	nia jax selfie	1
nintendo switch	nintendo switch	1
oblique workout	oblique workout	1
paul george	paul george	1
pembroke welsh corgi	pembroke welsh corgi	1
philadelphia eagles	philadelphia eagles	1
phil mickelson selfie	phil mickelson selfie	1
pittsburgh steelers	pittsburgh steelers	1
piyo workout	piyo workout	1
poke bowl calories	poke bowl calories	1
poodle	poodle	1
pork chops recipe	pork chops recipe	1
post malone	post malone	1
razer phone	razer phone	1
real madrid c.f.	real madrid c.f.	1
remy ma	remy ma	1
riverdale	riverdale	1
samsung galaxy s8	samsung galaxy s8	1
santa clarita diet	santa clarita diet	1
selfie rat	selfie rat	1
sergio garcia	sergio garcia	1
sevilla fc	sevilla fc	1
shape of you	shape of you	1
shiba inu	shiba inu	1
side to side	side to side	1
solar eclipse	solar eclipse	1
super bowl	super bowl	1
super nes classic	super nes classic	1
tabata workout	tabata workout	1
tesla	tesla	1
the good doctor	the good doctor	1
this is us	this is us	1
tom holland	tom holland	1
tommy wiseau	tommy wiseau	1
tom petty	tom petty	1
tony romo	tony romo	1
toyota	toyota	1
triple double crunchwrap calories	triple double crunchwrap calories	1
trx workout	trx workout	1
uc berkeley protests	uc berkeley protests	1
unicorn frappuccino calories	unicorn frappuccino calories	1
venezuelan protests	venezuelan protests	1
what is a fidget spinner ?	what is a fidget spinner ?	1
what is a hurricane ?	what is a hurricane ?	1
what is antifa ?	what is antifa ?	1
what is a solar eclipse ?	what is a solar eclipse ?	1
what is bitcoin ?	what is bitcoin ?	1
what is covfefe ?	what is covfefe ?	1
what is daca ?	what is daca ?	1
what is net neutrality ?	what is net neutrality ?	1
what is the antikythera mechanism ?	what is the antikythera mechanism ?	1
women 's march	women 's march	1
wonder woman	wonder woman	1
yams recipe	yams recipe	1
zima calories	zima calories	1
zucchini recipe	zucchini recipe	1
youtube	youtube	1
facebook	facebook	1
amazon	amazon	1
gmail	gmail	1
google	google	1
craigslist	craigslist	1
ebay	ebay	1
netflix	netflix	1
walmart	walmart	1
google maps	google maps	1
yahoo mail	yahoo mail	1
yahoo	yahoo	1
google translate	google translate	1
weather	weather	1
facebook login	facebook login	1
home depot	home depot	1
maps	maps	1
google docs	google docs	1
translate	translate	1
target	target	1
pornhub	pornhub	1
paypal	paypal	1
usps tracking	usps tracking	1
hotmail	hotmail	1
lowes	lowes	1
calculator	calculator	1
best buy	best buy	1
google drive	google drive	1
pinterest	pinterest	1
pandora	pandora	1
bank of america	bank of america	1
youtube to mp3	youtube to mp3	1
wells fargo	wells fargo	1
instagram	instagram	1
google classroom	google classroom	1
zillow	zillow	1
speed test	speed test	1
linkedin	linkedin	1
cnn	cnn	1
twitter	twitter	1
mapquest	mapquest	1
indeed	indeed	1
costco	costco	1
ups tracking	ups tracking	1
capital one	capital one	1
usps	usps	1
you tube	you tube	1
pizza hut	pizza hut	1
amazon prime	amazon prime	1
espn	espn	1
kohls	kohls	1
xnxx	xnxx	1
roblox	roblox	1
american airlines	american airlines	1
chase	chase	1
xvideos	xvideos	1
dominos	dominos	1
verizon	verizon	1
news	news	1
fox news	fox news	1
hulu	hulu	1
spotify	spotify	1
etsy	etsy	1
expedia	expedia	1
msn	msn	1
macys	macys	1
turbotax	turbotax	1
porn	porn	1
steam	steam	1
bed bath and beyond	bed bath and beyond	1
gamestop	gamestop	1
dropbox	dropbox	1
airbnb	airbnb	1
you	you	1
groupon	groupon	1
thesaurus	thesaurus	1
southwest	southwest	1
aol mail	aol mail	1
reddit	reddit	1
papa johns	papa johns	1
united airlines	united airlines	1
walgreens	walgreens	1
fedex tracking	fedex tracking	1
twitch	twitch	1
google scholar	google scholar	1
autozone	autozone	1
soundcloud	soundcloud	1
jcpenney	jcpenney	1
123movies	123movies	1
credit karma	credit karma	1
ikea	ikea	1
powerball	powerball	1
imdb	imdb	1
donald trump	donald trump	1
southwest airlines	southwest airlines	1
comcast	comcast	1
minecraft	minecraft	1
bing	bing	1
traductor	traductor	1
xhamster	xhamster	1
johann carl friedrich gauß	johann carl friedrich gauß	1
nasim aghdam	nasim aghdam	1
masters leaderboard 2018	masters leaderboard 2018	1
avicii cause of death	avicii cause of death	1
radical heights	radical heights	1
joseph james deangelo	joseph james deangelo	1
alek minassian	alek minassian	1
nasim najafi aghdam	nasim najafi aghdam	1
yodeling walmart kid	yodeling walmart kid	1
how did avicii die	how did avicii die	1
tammie jo shults	tammie jo shults	1
nice for what	nice for what	1
bully hunters	bully hunters	1
mr peanut domestic violence	mr peanut domestic violence	1
walmart yodeling kid	walmart yodeling kid	1
josh allen tweets	josh allen tweets	1
j cole kod	j cole kod	1
toronto van attack	toronto van attack	1
overwatch retribution	overwatch retribution	1
nice for what lyrics	nice for what lyrics	1
search between 3 boats	search between 3 boats	1
kulve taroth	kulve taroth	1
yodeling kid	yodeling kid	1
teddy perkins	teddy perkins	1
ye vs the people	ye vs the people	1
drake nice for what	drake nice for what	1
youtube hq shooting	youtube hq shooting	1
devyn holmes	devyn holmes	1
john hubert highnote	john hubert highnote	1
verne troyer cause of death	verne troyer cause of death	1
lift yourself	lift yourself	1
zuckerberg testimony	zuckerberg testimony	1
shudderwock	shudderwock	1
overwatch retribution skins	overwatch retribution skins	1
sammy sosa hat	sammy sosa hat	1
starbucks arrest	starbucks arrest	1
mr. peanut domestic violence	mr. peanut domestic violence	1
avicii death cause	avicii death cause	1
bushworld adventures	bushworld adventures	1
retail row treasure map	retail row treasure map	1
harry anderson cause of death	harry anderson cause of death	1
spyro reignited	spyro reignited	1
beyonce coachella performance	beyonce coachella performance	1
michelle wolf speech	michelle wolf speech	1
bullyhunters	bullyhunters	1
zuckerberg hearing	zuckerberg hearing	1
kanye west lift yourself	kanye west lift yourself	1
romaine recall 2018 brands	romaine recall 2018 brands	1
fortnite master	fortnite master	1
fortnite dance floors	fortnite dance floors	1
kendrick lamar pulitzer	kendrick lamar pulitzer	1
no tears left to cry lyrics	no tears left to cry lyrics	1
spyro reignited trilogy	spyro reignited trilogy	1
humboldt broncos crash	humboldt broncos crash	1
dance floors fortnite	dance floors fortnite	1
kill edward	kill edward	1
jan blankers	jan blankers	1
brenna spencer	brenna spencer	1
nicki minaj chun li	nicki minaj chun li	1
darling in the franxx episode 15	darling in the franxx episode 15	1
tony finau ankle	tony finau ankle	1
caren z. turner	caren z. turner	1
darling in the franxx episode 14	darling in the franxx episode 14	1
walmart yodel	walmart yodel	1
yodeling boy	yodeling boy	1
toronto van	toronto van	1
yodel kid	yodel kid	1
1.106708 ms23	1.106708 ms23	1
search between three boats	search between three boats	1
taco shops fortnite	taco shops fortnite	1
new royal baby name	new royal baby name	1
todd brassner	todd brassner	1
dance on different dance floors	dance on different dance floors	1
jennair gerardot	jennair gerardot	1
fortnite taco shops	fortnite taco shops	1
youtube headquarters shooting	youtube headquarters shooting	1
karen mcdougal l	karen mcdougal l	1
beyonce coachella youtube	beyonce coachella youtube	1
chun li lyrics	chun li lyrics	1
starbucks arrest video	starbucks arrest video	1
treasure map in moisty mire	treasure map in moisty mire	1
chikesia clemons	chikesia clemons	1
jersey shore family vacation episode 3	jersey shore family vacation episode 3	1
my hero academia season 3 episode 4	my hero academia season 3 episode 4	1
nasim aghdam youtube channel	nasim aghdam youtube channel	1
nasimesabz	nasimesabz	1
kod j cole	kod j cole	1
jersey shore family vacation episode 2	jersey shore family vacation episode 2	1
stormy daniels sketch	stormy daniels sketch	1
saheed vassell	saheed vassell	1
beyonce coachella video	beyonce coachella video	1
yodeling walmart kid remix	yodeling walmart kid remix	1
apyr meme	apyr meme	1
yodeling kid remix	yodeling kid remix	1
barbie tingz	barbie tingz	1
wrestlemania 2018 results	wrestlemania 2018 results	1
lupin unbound	lupin unbound	1
avicii suicide	avicii suicide	1
harry anderson death	harry anderson death	1
shooter at youtube	shooter at youtube	1
