ابرکوه	ابرکوه	1
ابریشم	ابریشم	1
ابوزیدآباد	ابوزیدآباد	1
ابوموسی	ابوموسی	1
ابهر	ابهر	1
احمدآباد صولت	احمدآباد صولت	1
احمدآباد	احمدآباد	1
احمدسرگوراب	احمدسرگوراب	1
اختیارآباد	اختیارآباد	1
ادیمی	ادیمی	1
اراک	اراک	1
ارجمند	ارجمند	1
ارداق	ارداق	1
اردبیل	اردبیل	1
اردستان	اردستان	1
اردکان	اردکان	1
اردکان	اردکان	1
اردل	اردل	1
ارزوئیه	ارزوئیه	1
ارسک	ارسک	1
ارسنجان	ارسنجان	1
ارکواز	ارکواز	1
ارمغان‌خانه	ارمغان‌خانه	1
ارومیه	ارومیه	1
اروندکنار	اروندکنار	1
ازگله	ازگله	1
ازنا	ازنا	1
ازندریان	ازندریان	1
اژیه	اژیه	1
اسارا	اسارا	1
اسالم	اسالم	1
اسپکه	اسپکه	1
استهبان	استهبان	1
اسدآباد	اسدآباد	1
اسدیه	اسدیه	1
اسفدن	اسفدن	1
اسفراین	اسفراین	1
اسفرورین	اسفرورین	1
اسکو	اسکو	1
اسلام‌آباد غرب	اسلام‌آباد غرب	1
اسلام‌شهر	اسلام‌شهر	1
اسلامیه	اسلامیه	1
اسلام‌شهر آق‌گل	اسلام‌شهر آق‌گل	1
اسیر	اسیر	1
اشترینان	اشترینان	1
اشتهارد	اشتهارد	1
اشکذر	اشکذر	1
اشکنان	اشکنان	1
اشنویه	اشنویه	1
اصفهان	اصفهان	1
اصلاندوز	اصلاندوز	1
اتاقور	اتاقور	1
افزر	افزر	1
افوس	افوس	1
اقبالیه	اقبالیه	1
اقلید	اقلید	1
الشتر	الشتر	1
الوان	الوان	1
الوند	الوند	1
الیگودرز	الیگودرز	1
امام حسن	امام حسن	1
امام‌شهر	امام‌شهر	1
املش	املش	1
امیدیه	امیدیه	1
امیرکلا	امیرکلا	1
امیریه	امیریه	1
امین‌شهر	امین‌شهر	1
انابد	انابد	1
انار	انار	1
انارستان	انارستان	1
انارک	انارک	1
انبارآلوم	انبارآلوم	1
اندوهجرد	اندوهجرد	1
اندیشه	اندیشه	1
اندیمشک	اندیمشک	1
اوز	اوز	1
اهر	اهر	1
اهرم	اهرم	1
اهل	اهل	1
اهواز	اهواز	1
ایج	ایج	1
ایذه	ایذه	1
ایرانشهر	ایرانشهر	1
ایزدخواست	ایزدخواست	1
ایزدشهر	ایزدشهر	1
ایلام	ایلام	1
ایلخچی	ایلخچی	1
ایمان‌شهر	ایمان‌شهر	1
اینچه‌برون	اینچه‌برون	1
ایوان	ایوان	1
ایوانکی	ایوانکی	1
ایواوغلی	ایواوغلی	1
ایور	ایور	1
ب[ویرایش]	ب[ویرایش]	1
نام	نام	1
باب انار	باب انار	1
باباحیدر	باباحیدر	1
بابارشانی	بابارشانی	1
بابل	بابل	1
بابلسر	بابلسر	1
باجگیران	باجگیران	1
باخرز	باخرز	1
بادرود	بادرود	1
بار	بار	1
باروق	باروق	1
بازار جمعه	بازار جمعه	1
بازرگان	بازرگان	1
باسمنج	باسمنج	1
باشت	باشت	1
باغ بهادران	باغ بهادران	1
باغ‌ملک	باغ‌ملک	1
باغستان	باغستان	1
باغین	باغین	1
بافت	بافت	1
بافران	بافران	1
بافق	بافق	1
باقرشهر	باقرشهر	1
بالاده	بالاده	1
بانه	بانه	1
بانه‌وره	بانه‌وره	1
بایگ	بایگ	1
باینگان	باینگان	1
بجستان	بجستان	1
بجنورد	بجنورد	1
بخشایش	بخشایش	1
بدره	بدره	1
برازجان	برازجان	1
بردخون	بردخون	1
بردستان	بردستان	1
بردسکن	بردسکن	1
بردسیر	بردسیر	1
برزک	برزک	1
برزول	برزول	1
برف‌انبار	برف‌انبار	1
بروات	بروات	1
بروجرد	بروجرد	1
بروجن	بروجن	1
بره‌سر	بره‌سر	1
بزمان	بزمان	1
بزنجان	بزنجان	1
بستان	بستان	1
بستان‌آباد	بستان‌آباد	1
بستک	بستک	1
بسطام	بسطام	1
بشرویه	بشرویه	1
بفروئیه	بفروئیه	1
بلبان‌آباد	بلبان‌آباد	1
بلداجی	بلداجی	1
بلده	بلده	1
بم	بم	1
بمپور	بمپور	1
بن	بن	1
بناب	بناب	1
بناب جدید	بناب جدید	1
بنارویه	بنارویه	1
بنت	بنت	1
بنجار	بنجار	1
بندر امام خمینی	بندر امام خمینی	1
بندر انزلی	بندر انزلی	1
بندر ترکمن	بندر ترکمن	1
بندر جاسک	بندر جاسک	1
بندر دیر	بندر دیر	1
بندر دیلم	بندر دیلم	1
بندر ریگ	بندر ریگ	1
بندرعباس	بندرعباس	1
بندر کنگان	بندر کنگان	1
بندر گز	بندر گز	1
بندر گناوه	بندر گناوه	1
بندر لنگه	بندر لنگه	1
بندر ماهشهر	بندر ماهشهر	1
بنک	بنک	1
بوانات	بوانات	1
بوشهر	بوشهر	1
بوکان	بوکان	1
بومهن	بومهن	1
بوئین‌زهرا	بوئین‌زهرا	1
بویین سفلی	بویین سفلی	1
بوئین و میاندشت	بوئین و میاندشت	1
بهاباد	بهاباد	1
بهار	بهار	1
بهاران‌شهر	بهاران‌شهر	1
بهارستان	بهارستان	1
بهبهان	بهبهان	1
بهرمان	بهرمان	1
بهشهر	بهشهر	1
بهمن	بهمن	1
بهنمیر	بهنمیر	1
بیارجمند	بیارجمند	1
بیجار	بیجار	1
بیدخت	بیدخت	1
بیدستان	بیدستان	1
بیرجند	بیرجند	1
بیرم	بیرم	1
بیستون	بیستون	1
بیضا	بیضا	1
بیکا	بیکا	1
بیله‌سوار	بیله‌سوار	1
پ[ویرایش]	پ[ویرایش]	1
نام	نام	1
پاتاوه	پاتاوه	1
پارس‌آباد	پارس‌آباد	1
پارسیان	پارسیان	1
پاریز	پاریز	1
پاکدشت	پاکدشت	1
پاوه	پاوه	1
پردنجان	پردنجان	1
پردیس	پردیس	1
پرندک (زرندیه)	پرندک (زرندیه)	1
پره‌سر	پره‌سر	1
پل‌دختر	پل‌دختر	1
پل سفید	پل سفید	1
پلدشت	پلدشت	1
پول	پول	1
پهله	پهله	1
پیرانشهر	پیرانشهر	1
پیربکران	پیربکران	1
پیش‌قلعه	پیش‌قلعه	1
پیشوا	پیشوا	1
پیشین	پیشین	1
ت[ویرایش]	ت[ویرایش]	1
نام	نام	1
تازه‌آباد	تازه‌آباد	1
تازه‌شهر	تازه‌شهر	1
تازه‌کند	تازه‌کند	1
تازه‌کند انگوت	تازه‌کند انگوت	1
تاکستان	تاکستان	1
طوالش	طوالش	1
تایباد	تایباد	1
تبریز	تبریز	1
تخت	تخت	1
تربت جام	تربت جام	1
تربت حیدریه	تربت حیدریه	1
ترک	ترک	1
ترکالکی	ترکالکی	1
ترکمانچای	ترکمانچای	1
تسوج	تسوج	1
تفت	تفت	1
تفرش	تفرش	1
تکاب	تکاب	1
تنکابن	تنکابن	1
تنکمان	تنکمان	1
تنگ ارم	تنگ ارم	1
توتکابن	توتکابن	1
توحید	توحید	1
تودشک	تودشک	1
توره	توره	1
تویسرکان	تویسرکان	1
تهران	تهران	1
تیتکانلو	تیتکانلو	1
تیران	تیران	1
تیکمه‌داش	تیکمه‌داش	1
ج[ویرایش]	ج[ویرایش]	1
نام	نام	1
جاجرم	جاجرم	1
جالق	جالق	1
جاورسیان	جاورسیان	1
جایزان	جایزان	1
جبالبارز	جبالبارز	1
جعفرآباد	جعفرآباد	1
جعفریه	جعفریه	1
جغتای	جغتای	1
جلفا	جلفا	1
جلین	جلین	1
جم	جم	1
جناح	جناح	1
جنت‌شهر	جنت‌شهر	1
جنت‌مکان	جنت‌مکان	1
جندق	جندق	1
جنگل	جنگل	1
جوادآباد	جوادآباد	1
جوانرود	جوانرود	1
جوپار	جوپار	1
جورقان	جورقان	1
جوزدان	جوزدان	1
جوزم	جوزم	1
جوشقان و کامو	جوشقان و کامو	1
جوکار	جوکار	1
جونقان	جونقان	1
جویبار	جویبار	1
جویم	جویم	1
جهرم	جهرم	1
جیرفت	جیرفت	1
جیرنده	جیرنده	1
چ[ویرایش]	چ[ویرایش]	1
نام	نام	1
چابکسر	چابکسر	1
چاپشلو	چاپشلو	1
چادگان	چادگان	1
چارک	چارک	1
چاف و چمخاله	چاف و چمخاله	1
چالانچولان	چالانچولان	1
چالوس	چالوس	1
چاه بهار	چاه بهار	1
چترود	چترود	1
چرام	چرام	1
چرمهین	چرمهین	1
چغادک	چغادک	1
چغامیش	چغامیش	1
چغلوندی	چغلوندی	1
چقابل	چقابل	1
چکنه	چکنه	1
چلگرد	چلگرد	1
چمران	چمران	1
چمستان	چمستان	1
چمگردان	چمگردان	1
چناران	چناران	1
چناره	چناره	1
چوار	چوار	1
چوبر	چوبر	1
چورزق	چورزق	1
چویبده	چویبده	1
چهارباغ	چهارباغ	1
چهاربرج	چهاربرج	1
چهاردانگه	چهاردانگه	1
چیتاب	چیتاب	1
ح[ویرایش]	ح[ویرایش]	1
نام	نام	1
حاجی‌آباد	حاجی‌آباد	1
حاجی‌آباد	حاجی‌آباد	1
حاجی‌آباد	حاجی‌آباد	1
حبیب‌آباد	حبیب‌آباد	1
حر	حر	1
حسامی	حسامی	1
حسن‌آباد	حسن‌آباد	1
حسن‌آباد	حسن‌آباد	1
حسن‌آباد	حسن‌آباد	1
حسینیه	حسینیه	1
حصارگرمخان	حصارگرمخان	1
حلب	حلب	1
حمزه	حمزه	1
حمیدیا	حمیدیا	1
حمیدیه	حمیدیه	1
حمیل	حمیل	1
حنا	حنا	1
حویق	حویق	1
خ[ویرایش]	خ[ویرایش]	1
نام	نام	1
خاتون آباد	خاتون آباد	1
جزیره خارگ	جزیره خارگ	1
خاروانا	خاروانا	1
خاش	خاش	1
خاکعلی	خاکعلی	1
خالدآباد	خالدآباد	1
خامنه	خامنه	1
خان‌ببین	خان‌ببین	1
خانوک	خانوک	1
خانه زنیان	خانه زنیان	1
خاوران	خاوران	1
خداجو	خداجو	1
خرامه	خرامه	1
خرم‌آباد (لرستان)	خرم‌آباد (لرستان)	1
خرم‌آباد (مازندران)	خرم‌آباد (مازندران)	1
خرمدره	خرمدره	1
خرمدشت (تاکستان)	خرمدشت (تاکستان)	1
خرمشهر	خرمشهر	1
خرو (نیشابور)	خرو (نیشابور)	1
خسروشهر	خسروشهر	1
خشت	خشت	1
خشکبیجار	خشکبیجار	1
خشکرود	خشکرود	1
خضرآباد	خضرآباد	1
خضری دشت‌بیاض	خضری دشت‌بیاض	1
خلخال	خلخال	1
خلیفان	خلیفان	1
خلیل‌آباد	خلیل‌آباد	1
خلیل کرد	خلیل کرد	1
خلیل‌شهر	خلیل‌شهر	1
خمارلو	خمارلو	1
خمام	خمام	1
خمیر	خمیر	1
خمین	خمین	1
خمینی‌شهر	خمینی‌شهر	1
خنج	خنج	1
خنداب	خنداب	1
خواجه	خواجه	1
خواف	خواف	1
خوانسار	خوانسار	1
خور	خور	1
خور	خور	1
خوراسگان	خوراسگان	1
خورزوق	خورزوق	1
خورسند	خورسند	1
خورموج	خورموج	1
خوسف	خوسف	1
خوش‌رودپی	خوش‌رودپی	1
خومه‌زار	خومه‌زار	1
خوی	خوی	1
د[ویرایش]	د[ویرایش]	1
نام	نام	1
دابودشت	دابودشت	1
داراب	داراب	1
داران	داران	1
دارخوین	دارخوین	1
داریان	داریان	1
دالکی	دالکی	1
دامغان	دامغان	1
دامنه	دامنه	1
دانسفهان	دانسفهان	1
داوودآباد	داوودآباد	1
داورزن	داورزن	1
دبیران	دبیران	1
درب بهشت	درب بهشت	1
درب گنبد	درب گنبد	1
درجزین	درجزین	1
درچه	درچه	1
درق	درق	1
درگز	درگز	1
درگهان	درگهان	1
درود	درود	1
دره‌شهر	دره‌شهر	1
دزآب	دزآب	1
دزج	دزج	1
دزفول	دزفول	1
دژکرد	دژکرد	1
دستجرد	دستجرد	1
دستگرد	دستگرد	1
دستنا	دستنا	1
دلبران	دلبران	1
دلگشا	دلگشا	1
دلند	دلند	1
دلوار	دلوار	1
دلیجان (مرکزی)	دلیجان (مرکزی)	1
دماوند	دماوند	1
دمق	دمق	1
دندی	دندی	1
دوبرجی	دوبرجی	1
دورود	دورود	1
دوزدوزان	دوزدوزان	1
دوزه	دوزه	1
دوساری	دوساری	1
دوست‌محمد	دوست‌محمد	1
دوگنبدان	دوگنبدان	1
دولت‌آباد (اصفهان)	دولت‌آباد (اصفهان)	1
دولت‌آباد (خراسان رضوی)	دولت‌آباد (خراسان رضوی)	1
دهاقان	دهاقان	1
دهبارز	دهبارز	1
دهج	دهج	1
دهدز	دهدز	1
دهدشت	دهدشت	1
دهرم	دهرم	1
دهق	دهق	1
دهگلان	دهگلان	1
دهلران	دهلران	1
دیباج	دیباج	1
دیزج دیز	دیزج دیز	1
دیزیچه	دیزیچه	1
دیشموک	دیشموک	1
دیلمان	دیلمان	1
دیواندره	دیواندره	1
دیهوک	دیهوک	1
دشتک	دشتک	1
ر[ویرایش]	ر[ویرایش]	1
نام	نام	1
رابر	رابر	1
راز	راز	1
رازقان	رازقان	1
رازمیان	رازمیان	1
راسک	راسک	1
رامجرد	رامجرد	1
رامسر	رامسر	1
رامشیر	رامشیر	1
رامهرمز	رامهرمز	1
رامیان	رامیان	1
رانکوه	رانکوه	1
راور	راور	1
راین	راین	1
رباط	رباط	1
رباط سنگ	رباط سنگ	1
رباط‌کریم	رباط‌کریم	1
ربط	ربط	1
رحیم‌آباد	رحیم‌آباد	1
رزن	رزن	1
رزوه	رزوه	1
رستم‌آباد	رستم‌آباد	1
رستمکلا	رستمکلا	1
رشت	رشت	1
رشتخوار	رشتخوار	1
رضوان‌شهر (اصفهان)	رضوان‌شهر (اصفهان)	1
رضوان‌شهر (گیلان)	رضوان‌شهر (گیلان)	1
رضویه	رضویه	1
رضی	رضی	1
رفسنجان	رفسنجان	1
رفیع	رفیع	1
روانسر	روانسر	1
روداب	روداب	1
رودبار (کرمان)	رودبار (کرمان)	1
رودبار (گیلان)	رودبار (گیلان)	1
رودبنه	رودبنه	1
رودسر	رودسر	1
رودهن	رودهن	1
رونیز	رونیز	1
رویان	رویان	1
رویدر	رویدر	1
ریحان‌شهر	ریحان‌شهر	1
ریز	ریز	1
رینه	رینه	1
ریوش	ریوش	1